x,y,p,m,f,ta
76,24,15,11,4,898.5
76,28,7,3,4,424.9
80,28,20,6,14,646
80,48,26,12,14,767
84,28,1,1,0,0
84,48,44,22,22,1183.6
88,28,1,1,0,0
88,48,179,92,87,7088.4
88,52,184,105,79,9163.2
88,80,1,1,0,0
88,84,1,1,0,0
92,48,154,86,68,6760.6
92,52,408,229,179,17503.2
100,40,9,3,6,306
104,24,1,0,1,0
108,52,1,1,0,0