x,y,p,m,f,ta
0,9,13,7,6,460.2
0,10,55,26,29,2403.5
0,12,8,5,3,332
0,86,21,13,8,810.6
0,92,14,7,7,505.4
0,93,9,6,3,397.8
0,94,35,21,14,1529.5
1,8,1,1,0,0
1,10,12,7,5,288
1,11,11,6,5,536.8
1,12,5,2,3,240
1,13,11,4,7,620.4
1,19,2,1,1,0
1,86,14,9,5,589.4
1,87,16,7,9,577.6
1,91,3,2,1,0
1,92,13,4,9,579.8
1,93,9,5,4,392.4
1,94,5,2,3,164
2,13,22,10,12,910.8
2,86,19,9,10,1020.3
2,87,35,18,17,1368.5
2,91,31,19,12,1342.3
2,92,8,5,3,467.2
2,93,6,3,3,358.8
3,12,14,7,7,565.6
3,13,14,7,7,911.4
3,14,11,7,4,416.9
3,86,3,2,1,0
3,87,45,23,22,2164.5
3,90,14,8,6,530.6
3,92,8,4,4,387.2
4,13,36,17,19,1432.8
4,14,42,23,19,1701
4,15,6,2,4,220.8
4,87,15,11,4,637.5
4,88,135,73,62,5616
4,89,271,125,146,10541.9
4,90,5,2,3,315
5,11,2,2,0,0
5,13,3,1,2,0
5,14,57,28,29,2223
5,15,8,2,6,386.4
5,88,321,148,173,14573.4
5,89,84,47,37,3393.6
6,11,12,8,4,432
6,12,30,14,16,1296
6,13,19,9,10,748.6
6,14,2,1,1,0
6,15,18,8,10,806.4
6,88,49,22,27,1842.4
6,89,30,13,17,948
7,13,3,1,2,0
7,14,10,4,6,393
7,89,51,29,22,2284.8
7,90,6,4,2,154.8
7,91,3,2,1,0
8,11,23,13,10,1048.8
8,12,13,6,7,559
8,13,9,4,5,343.8
8,89,47,17,30,1875.3
8,90,22,12,10,1082.4
8,91,15,8,7,571.5
9,9,3,1,2,0
9,10,1,1,0,0
9,12,8,5,3,375.2
9,14,2,1,1,0
9,90,17,9,8,712.3
9,91,9,4,5,270.9
9,127,8,5,3,304.8
10,8,16,8,8,569.6
10,9,18,7,11,988.2
10,10,29,15,14,1545.7
10,11,17,9,8,824.5
10,12,25,17,8,1115
10,14,6,3,3,174
10,23,16,8,8,696
10,90,12,7,5,555.6
10,91,22,12,10,671
10,127,9,5,4,216
11,8,27,14,13,1190.7
11,9,105,58,47,4105.5
11,10,31,17,14,1289.6
11,11,19,11,8,1094.4
11,20,2,1,1,0
11,23,4,3,1,0
11,91,50,29,21,2185
11,92,9,6,3,381.6
11,126,3,1,2,0
11,127,5,2,3,88
12,5,1,1,0,0
12,7,2,1,1,0
12,8,21,12,9,949.2
12,9,44,23,21,2081.2
12,10,36,21,15,1479.6
12,11,16,8,8,779.2
12,19,3,1,2,0
12,22,5,4,1,204
12,23,4,3,1,0
12,31,1,0,1,0
12,89,17,7,10,555.9
12,90,36,16,20,1450.8
12,91,39,21,18,1595.1
12,92,4,2,2,0
12,125,7,4,3,293.3
12,126,9,4,5,380.7
13,7,25,14,11,1147.5
13,8,20,12,8,878
13,9,11,3,8,430.1
13,10,36,23,13,1267.2
13,21,10,6,4,540
13,89,33,19,14,1511.4
13,91,32,18,14,1126.4
13,92,20,9,11,860
13,124,10,5,5,546
13,125,20,8,12,722
13,126,1,0,1,0
14,4,1,0,1,0
14,7,15,11,4,670.5
14,8,1,0,1,0
14,9,22,12,10,1135.2
14,10,17,9,8,793.9
14,13,2,0,2,0
14,21,14,8,6,897.4
14,89,32,16,16,1609.6
14,91,14,7,7,900.2
14,92,5,3,2,278
14,122,13,6,7,516.1
14,123,29,16,13,1017.9
14,124,6,3,3,277.2
15,7,20,12,8,878
15,9,64,33,31,2502.4
15,10,8,6,2,203.2
15,20,15,6,9,538.5
15,21,48,25,23,1718.4
15,88,11,4,7,317.9
15,89,12,6,6,523.2
15,91,11,7,4,449.9
15,118,1,1,0,0
15,121,23,11,12,1136.2
15,122,52,27,25,1996.8
15,123,8,4,4,484
16,5,15,8,7,675
16,6,25,16,9,1170
16,7,8,3,5,279.2
16,8,13,7,6,551.2
16,9,6,2,4,391.2
16,12,8,4,4,332
16,13,3,2,1,0
16,18,8,4,4,244.8
16,19,21,12,9,613.2
16,20,28,14,14,834.4
16,21,13,5,8,579.8
16,88,7,5,2,329
16,89,20,11,9,978
16,91,19,12,7,815.1
16,120,47,25,22,1532.2
16,121,19,7,12,769.5
17,5,13,5,8,552.5
17,6,19,10,9,849.3
17,8,40,18,22,1656
17,13,6,4,2,165
17,17,10,5,5,556
17,18,12,4,8,328.8
17,20,7,3,4,298.9
17,21,99,47,52,3722.4
17,51,1,1,0,0
17,88,23,11,12,899.3
17,89,93,47,46,3673.5
17,91,9,5,4,531.9
17,92,3,1,2,0
17,119,42,25,17,1604.4
17,120,29,17,12,1267.3
18,2,14,6,8,572.6
18,3,18,10,8,774
18,4,7,4,3,223.3
18,5,17,8,9,739.5
18,6,37,22,15,1576.2
18,7,41,22,19,1586.7
18,8,15,4,11,637.5
18,12,8,4,4,228
18,13,26,14,12,959.4
18,16,4,3,1,0
18,17,15,9,6,619.5
18,18,2,1,1,0
18,19,34,13,21,1519.8
18,20,161,78,83,6085.8
18,21,60,32,28,2148
18,86,1,1,0,0
18,88,43,24,19,1849
18,89,78,39,39,3510
18,90,15,8,7,535.5
18,118,3,2,1,0
18,119,45,27,18,1939.5
18,120,23,13,10,899.3
19,0,9,5,4,303.3
19,1,22,8,14,937.2
19,2,10,4,6,488
19,3,77,37,40,3226.3
19,4,52,23,29,2537.6
19,5,33,18,15,1346.4
19,6,7,5,2,450.1
19,12,31,15,16,1168.7
19,13,6,3,3,223.8
19,14,1,0,1,0
19,15,2,1,1,0
19,16,30,16,14,1149
19,17,33,17,16,1725.9
19,88,48,28,20,2404.8
19,90,4,3,1,0
19,118,2,1,1,0
19,119,58,34,24,2494
19,120,4,2,2,0
20,0,22,11,11,941.6
20,1,22,12,10,778.8
20,2,57,28,29,1995
20,3,243,112,131,12174.3
20,4,22,9,13,1020.8
20,11,5,2,3,188
20,12,3,2,1,0
20,13,5,3,2,168
20,14,19,12,7,695.4
20,15,40,16,24,1840
20,16,22,12,10,1214.4
20,88,41,22,19,1804
20,118,8,4,4,491.2
20,119,39,22,17,1431.3
21,0,13,5,8,496.6
21,1,42,24,18,1768.2
21,2,9,5,4,531
21,3,11,6,5,390.5
21,11,33,17,16,1227.6
21,12,18,8,10,498.6
21,13,29,16,13,1168.7
21,14,35,16,19,1354.5
21,15,16,10,6,489.6
21,89,5,2,3,279
21,118,29,15,14,1189
21,119,25,13,12,1015
22,0,23,12,11,715.3
22,1,22,13,9,932.8
22,6,8,4,4,284.8
22,10,6,4,2,295.8
22,11,39,18,21,1329.9
22,14,1,1,0,0
22,87,17,8,9,797.3
22,89,5,2,3,147
22,115,5,3,2,158
22,117,3,2,1,0
22,118,33,15,18,940.5
23,0,17,9,8,666.4
23,5,8,3,5,274.4
23,6,52,26,26,2288
23,7,37,21,16,1628
23,10,87,50,37,3523.5
23,11,35,17,18,1302
23,12,1,1,0,0
23,83,2,1,1,0
23,87,18,9,9,604.8
23,88,7,5,2,263.2
23,89,2,1,1,0
23,117,20,7,13,694
23,118,224,101,123,10796.8
24,4,10,5,5,234
24,5,12,6,6,511.2
24,6,87,43,44,3453.9
24,8,8,4,4,464.8
24,9,102,43,59,6109.8
24,10,5,3,2,232
24,11,28,16,12,1232
24,12,5,2,3,203
24,62,2,1,1,0
24,87,9,4,5,352.8
24,89,2,1,1,0
24,116,8,4,4,330.4
24,117,8,6,2,260
24,118,59,27,32,3221.4
25,0,5,2,3,194
25,1,28,14,14,1176
25,2,45,26,19,2128.5
25,3,6,3,3,370.2
25,5,4,2,2,0
25,6,32,16,16,876.8
25,7,32,18,14,1465.6
25,8,100,47,53,4030
25,9,122,49,73,5978
25,10,1,1,0,0
25,11,29,14,15,1104.9
25,12,11,7,4,412.5
25,83,1,1,0,0
25,85,3,2,1,0
25,87,34,16,18,1564
25,88,2,1,1,0
25,89,5,4,1,101
25,118,29,17,12,1099.1
26,0,6,2,4,190.2
26,1,12,5,7,531.6
26,3,6,5,1,145.2
26,4,34,16,18,1795.2
26,5,41,20,21,1562.1
26,6,131,60,71,5711.6
26,7,160,78,82,7216
26,10,12,6,6,453.6
26,11,36,19,17,1404
26,12,3,1,2,0
26,85,24,11,13,888
26,86,1,1,0,0
26,87,60,32,28,2094
26,88,25,14,11,1220
26,89,2,1,1,0
26,96,5,3,2,315
26,97,3,2,1,0
26,116,8,5,3,231.2
26,117,3,1,2,0
26,118,37,17,20,1468.9
26,125,4,3,1,0
27,0,3,1,2,0
27,1,65,32,33,2060.5
27,2,59,30,29,2867.4
27,3,96,50,46,3705.6
27,4,34,18,16,1363.4
27,5,41,24,17,1549.8
27,85,28,13,15,1243.2
27,87,19,8,11,716.3
27,88,3,1,2,0
27,89,45,21,24,1354.5
27,90,7,4,3,191.1
27,91,4,1,3,0
27,96,12,8,4,576
27,115,9,6,3,347.4
27,116,27,14,13,999
27,117,1,1,0,0
27,118,53,27,26,2475.1
27,124,5,2,3,79
28,0,66,34,32,2778.6
28,1,115,62,53,4082.5
28,3,43,22,21,1793.1
28,4,5,4,1,254
28,79,6,3,3,160.8
28,83,5,3,2,304
28,84,5,3,2,191
28,85,2,1,1,0
28,87,1,1,0,0
28,88,19,10,9,628.9
28,89,33,21,12,1316.7
28,90,20,12,8,978
28,94,11,8,3,522.5
28,95,21,8,13,1003.8
28,96,24,14,10,1003.2
28,97,18,8,10,574.2
28,115,16,7,9,745.6
28,116,2,1,1,0
28,117,28,14,14,1293.6
29,0,126,63,63,5178.6
29,1,26,13,13,1120.6
29,14,2,1,1,0
29,73,2,1,1,0
29,82,3,2,1,0
29,89,23,14,9,929.2
29,90,4,2,2,0
29,93,15,8,7,745.5
29,94,10,5,5,403
29,95,6,4,2,249
29,96,27,13,14,882.9
29,115,15,7,8,736.5
29,116,3,2,1,0
29,117,12,5,7,417.6
30,0,22,9,13,976.8
30,73,3,2,1,0
30,74,8,5,3,259.2
30,88,8,6,2,358.4
30,90,44,23,21,1980
30,92,11,6,5,567.6
30,93,11,5,6,469.7
30,113,1,1,0,0
30,115,13,8,5,525.2
30,116,11,7,4,353.1
31,9,3,1,2,0
31,73,19,11,8,754.3
31,74,24,12,12,1036.8
31,77,4,3,1,0
31,88,14,7,7,688.8
31,89,6,3,3,270
31,90,43,20,23,1582.4
31,92,31,15,16,1333
31,93,7,4,3,289.8
31,113,5,1,4,203
31,114,3,2,1,0
31,115,17,11,6,805.8
31,116,2,1,1,0
31,118,2,1,1,0
31,120,3,2,1,0
32,9,2,1,1,0
32,76,1,1,0,0
32,88,19,7,12,775.2
32,89,6,2,4,252
32,90,4,3,1,0
32,91,34,18,16,1404.2
32,92,43,18,25,1827.5
32,113,22,10,12,761.2
32,114,41,21,20,1517
32,115,19,9,10,672.6
33,74,4,1,3,0
33,88,4,3,1,0
33,89,109,46,63,4828.7
33,90,701,325,376,34489.2
33,91,108,61,47,4125.6
33,113,21,13,8,758.1
33,114,41,21,20,1496.5
33,115,4,2,2,0
34,88,21,10,11,701.4
34,89,57,30,27,2861.4
34,90,340,162,178,14212
34,91,81,44,37,4066.2
34,111,12,7,5,428.4
34,113,2,1,1,0
34,114,20,11,9,916
35,69,3,2,1,0
35,72,7,2,5,368.9
35,73,26,15,11,1118
35,74,7,5,2,417.2
35,75,7,6,1,357.7
35,88,3,3,0,0
35,89,36,21,15,1638
35,90,194,102,92,7216.8
35,91,17,8,9,766.7
35,110,7,3,4,146.3
35,111,19,9,10,541.5
35,112,1,1,0,0
35,113,35,18,17,1361.5
35,114,81,39,42,3199.5
36,67,3,2,1,0
36,73,6,4,2,277.8
36,74,40,20,20,2104
36,75,5,4,1,153
36,88,33,18,15,1287
36,89,12,8,4,612
36,90,32,19,13,1360
36,91,2,1,1,0
36,109,10,4,6,398
36,110,11,4,7,414.7
36,111,16,6,10,785.6
36,112,54,29,25,2278.8
36,113,18,8,10,727.2
36,114,36,19,17,1839.6
37,65,14,8,6,491.4
37,66,33,19,14,1310.1
37,67,10,5,5,571
37,71,4,3,1,0
37,73,6,5,1,153
37,74,2,1,1,0
37,75,12,7,5,619.2
37,86,2,1,1,0
37,87,11,6,5,432.3
37,88,43,26,17,1556.6
37,89,7,5,2,326.9
37,90,5,4,1,154
37,107,15,10,5,568.5
37,108,25,12,13,912.5
37,109,2,1,1,0
37,110,18,11,7,673.2
37,111,84,40,44,3805.2
37,112,434,219,215,18011
37,113,438,224,214,19053
38,64,1,1,0,0
38,65,17,12,5,623.9
38,66,2,1,1,0
38,74,6,3,3,279
38,75,29,15,14,1061.4
38,80,2,1,1,0
38,81,1,1,0,0
38,87,39,16,23,1743.3
38,88,52,26,26,1674.4
38,89,4,2,2,0
38,107,30,16,14,1014
38,108,58,29,29,2650.6
38,109,26,16,10,1198.6
38,112,135,67,68,6156
38,113,98,51,47,3273.2
39,74,22,9,13,767.8
39,75,17,9,8,647.7
39,76,4,3,1,0
39,81,2,1,1,0
39,86,49,23,26,1945.3
39,87,62,33,29,2765.2
39,88,34,20,14,1849.6
39,89,17,10,7,775.2
39,105,7,4,3,221.9
39,106,34,17,17,1224
39,107,16,6,10,734.4
39,108,5,4,1,135
40,75,20,12,8,882
40,76,30,13,17,1365
40,85,17,9,8,688.5
40,86,28,14,14,1201.2
40,87,8,4,4,370.4
40,88,11,6,5,467.5
40,97,3,2,1,0
40,103,2,1,1,0
40,104,6,3,3,235.8
40,105,14,7,7,639.8
40,106,18,10,8,959.4
40,107,3,2,1,0
41,75,18,9,9,698.4
41,76,22,12,10,838.2
41,77,27,13,14,1204.2
41,83,21,10,11,741.3
41,84,13,6,7,661.7
41,85,15,7,8,631.5
41,86,8,4,4,292.8
41,87,1,0,1,0
41,101,14,7,7,593.6
41,103,14,9,5,562.8
41,104,34,16,18,1611.6
41,105,26,16,10,956.8
41,106,23,12,11,848.7
42,75,19,12,7,1077.3
42,76,83,37,46,3685.2
42,77,3,1,2,0
42,81,6,2,4,298.2
42,82,110,60,50,4081
42,83,199,93,106,7979.9
42,84,14,8,6,757.4
42,85,25,12,13,1120
42,86,1,0,1,0
42,87,4,2,2,0
42,97,5,3,2,309
42,99,10,6,4,493
42,100,18,6,12,871.2
42,101,174,86,88,8647.8
42,102,124,60,64,5071.6
42,103,98,37,61,6036.8
42,104,9,4,5,497.7
42,105,7,3,4,286.3
43,45,4,3,1,0
43,75,58,35,23,2639
43,76,264,126,138,11853.6
43,81,33,16,17,1435.5
43,82,83,41,42,2622.8
43,83,26,11,15,1097.2
43,84,34,16,18,1094.8
43,85,20,13,7,958
43,87,2,1,1,0
43,96,4,3,1,0
43,97,16,9,7,814.4
43,98,38,17,21,1603.6
43,99,20,11,9,870
43,100,23,9,14,1071.8
43,101,34,15,19,1618.4
43,102,57,32,25,2188.8
43,103,31,16,15,1249.3
44,45,3,1,2,0
44,46,6,2,4,300
44,74,40,21,19,1652
44,75,70,31,39,2576
44,76,6,4,2,307.2
44,80,2,2,0,0
44,81,13,6,7,352.3
44,96,15,6,9,658.5
44,97,5,2,3,297
44,98,11,4,7,440
44,101,14,9,5,663.6
44,102,5,3,2,328
45,46,5,4,1,312
45,47,3,3,0,0
45,48,10,4,6,410
45,49,33,16,17,1197.9
45,73,14,10,4,757.4
45,74,30,18,12,1374
45,75,22,11,11,948.2
45,80,21,11,10,745.5
45,86,4,1,3,0
45,94,6,2,4,159
45,95,16,10,6,825.6
45,96,7,5,2,410.2
45,97,6,4,2,292.8
46,48,6,3,3,397.2
46,49,57,31,26,2684.7
46,50,57,29,28,2718.9
46,55,7,2,5,132.3
46,72,13,7,6,600.6
46,73,28,17,11,1195.6
46,74,2,1,1,0
46,79,3,2,1,0
46,80,1,1,0,0
46,93,11,5,6,433.4
46,94,62,29,33,2728
46,95,25,10,15,1062.5
46,96,2,1,1,0
46,116,3,2,1,0
47,49,19,11,8,887.3
47,50,37,18,19,1961
47,71,24,13,11,895.2
47,72,3,2,1,0
47,73,11,5,6,515.9
47,74,1,1,0,0
47,79,5,1,4,209
47,85,11,8,3,553.3
47,93,54,29,25,2343.6
47,94,14,8,6,551.6
47,95,4,3,1,0
48,43,10,6,4,366
48,44,2,2,0,0
48,49,11,8,3,677.6
48,50,2,1,1,0
48,51,49,24,25,2175.6
48,69,1,1,0,0
48,70,11,5,6,591.8
48,71,25,10,15,1115
48,72,7,3,4,265.3
48,78,6,4,2,211.8
48,79,5,4,1,223
48,83,11,5,6,378.4
48,84,25,13,12,1162.5
48,85,34,17,17,1322.6
48,91,10,4,6,291
48,92,8,4,4,446.4
48,93,6,3,3,196.2
49,43,7,4,3,331.1
49,49,11,3,8,350.9
49,51,15,8,7,690
49,52,15,9,6,862.5
49,53,3,1,2,0
49,54,5,4,1,267
49,69,35,18,17,1452.5
49,70,73,40,33,3321.5
49,71,14,6,8,553
49,78,12,7,5,360
49,79,19,8,11,739.1
49,83,10,3,7,277
49,84,93,47,46,3896.7
49,85,133,65,68,6091.4
49,87,2,1,1,0
49,88,11,7,4,390.5
49,89,2,1,1,0
49,90,28,14,14,1276.8
49,91,13,5,8,552.5
49,92,3,1,2,0
49,119,2,1,1,0
50,4,7,3,4,135.1
50,40,5,1,4,263
50,51,6,3,3,301.2
50,52,7,4,3,273
50,53,11,8,3,491.7
50,54,11,6,5,530.2
50,68,4,3,1,0
50,69,51,26,25,2274.6
50,70,16,11,5,798.4
50,71,7,5,2,371
50,79,14,6,8,744.8
50,82,3,2,1,0
50,84,40,18,22,1572
50,85,206,101,105,8796.2
50,86,143,77,66,5605.6
50,88,1,1,0,0
50,89,2,2,0,0
51,51,2,1,1,0
51,52,16,9,7,974.4
51,53,4,3,1,0
51,54,4,3,1,0
51,67,1,1,0,0
51,68,34,17,17,1815.6
51,69,27,17,10,1077.3
51,70,4,2,2,0
51,77,5,3,2,76
51,79,67,35,32,2485.7
51,84,8,2,6,312
51,85,9,5,4,401.4
51,119,5,4,1,102
52,37,3,1,2,0
52,53,14,6,8,620.2
52,54,4,2,2,0
52,67,6,3,3,270
52,68,3,3,0,0
52,77,34,18,16,1747.6
52,78,18,11,7,743.4
52,79,2,2,0,0
52,83,8,2,6,216
52,84,2,1,1,0
52,85,3,2,1,0
52,89,1,0,1,0
53,36,3,2,1,0
53,37,5,2,3,375
53,54,28,14,14,1310.4
53,55,22,13,9,1027.4
53,56,5,3,2,137
53,76,2,1,1,0
53,77,515,260,255,20548.5
53,78,54,27,27,1873.8
53,83,1,0,1,0
53,84,4,3,1,0
53,89,4,2,2,0
53,90,13,7,6,596.7
54,35,2,0,2,0
54,36,1,1,0,0
54,55,3,2,1,0
54,56,2,1,1,0
54,65,3,2,1,0
54,66,12,8,4,709.2
54,67,16,10,6,608
54,68,6,3,3,316.2
54,76,29,13,16,1400.7
54,77,177,87,90,6672.9
54,78,5,2,3,225
54,82,7,4,3,333.9
54,83,14,8,6,579.6
54,90,16,7,9,660.8
54,122,2,1,1,0
55,49,6,4,2,268.8
55,54,4,3,1,0
55,55,2,1,1,0
55,65,6,3,3,249
55,66,116,53,63,4373.2
55,67,7,5,2,319.2
55,68,16,7,9,766.4
55,69,15,7,8,739.5
55,70,1,1,0,0
55,71,43,23,20,1818.9
55,72,12,9,3,507.6
55,73,8,4,4,440
55,74,2,1,1,0
55,75,45,25,20,1638
55,76,622,281,341,28487.6
55,77,213,110,103,9499.8
55,78,5,3,2,126
55,81,7,4,3,375.2
55,82,15,8,7,517.5
55,83,5,2,3,186
56,33,5,1,4,139
56,48,8,5,3,451.2
56,54,11,6,5,596.2
56,55,6,1,5,195
56,61,4,2,2,0
56,65,40,20,20,1672
56,66,9,4,5,483.3
56,68,4,2,2,0
56,69,32,18,14,1452.8
56,70,19,11,8,606.1
56,71,209,105,104,7795.7
56,72,68,27,41,3719.6
56,73,30,17,13,1407
56,74,16,8,8,798.4
56,75,103,52,51,3996.4
56,76,407,180,227,19617.4
56,77,182,101,81,7917
56,78,129,73,56,4669.8
56,79,67,37,30,2391.9
56,80,16,8,8,748.8
56,81,8,3,5,348.8
56,82,9,6,3,234.9
57,32,6,3,3,411
57,53,10,6,4,578
57,54,32,16,16,1196.8
57,63,10,4,6,478
57,64,21,9,12,711.9
57,65,13,6,7,625.3
57,73,6,3,3,238.2
57,74,6,3,3,315
57,77,14,7,7,439.6
57,78,19,12,7,431.3
57,79,91,47,44,3494.4
57,80,57,33,24,2023.5
57,81,10,6,4,384
58,2,2,1,1,0
58,31,2,1,1,0
58,53,1,1,0,0
58,54,26,13,13,972.4
58,63,39,23,16,1712.1
58,64,31,15,16,1571.7
58,80,2,1,1,0
59,50,1,1,0,0
59,54,31,16,15,1230.7
59,55,3,1,2,0
59,63,9,5,4,430.2
59,64,23,12,11,910.8
59,78,34,20,14,924.8
59,89,4,3,1,0
60,30,1,1,0,0
60,49,2,1,1,0
60,54,39,22,17,1926.6
60,55,15,7,8,615
60,59,5,3,2,230
60,63,14,9,5,539
60,64,8,4,4,284.8
60,126,5,4,1,239
61,54,14,8,6,627.2
61,63,2,1,1,0
61,64,36,24,12,1443.6
61,65,12,8,4,394.8
61,126,3,2,1,0
62,29,6,3,3,292.2
62,30,5,4,1,272
62,52,3,2,1,0
62,53,97,44,53,3734.5
62,54,39,22,17,1474.2
62,55,11,6,5,464.2
62,58,4,3,1,0
62,63,15,9,6,501
62,64,602,288,314,25585
62,65,33,19,14,1504.8
62,66,15,8,7,702
62,67,6,3,3,226.8
62,126,12,6,6,361.2
62,127,2,1,1,0
63,26,7,4,3,245.7
63,28,11,5,6,471.9
63,29,20,12,8,868
63,30,3,2,1,0
63,53,29,12,17,1360.1
63,54,32,18,14,1395.2
63,55,139,76,63,4851.1
63,56,24,15,9,732
63,57,105,50,55,4252.5
63,58,9,4,5,378
63,59,17,8,9,816
63,60,26,12,14,904.8
63,61,4,3,1,0
63,64,134,64,70,5628
63,65,18,11,7,545.4
63,66,16,10,6,587.2
63,69,16,8,8,684.8
63,80,10,3,7,290
63,126,1,0,1,0
64,26,3,2,1,0
64,27,30,18,12,1575
64,28,35,17,18,1389.5
64,29,3,1,2,0
64,53,20,12,8,990
64,54,70,38,32,2702
64,55,19,8,11,807.5
64,56,209,102,107,8694.4
64,57,617,296,321,28813.9
64,58,27,11,16,982.8
64,59,17,9,8,576.3
64,60,33,17,16,1729.2
64,61,23,13,10,1143.1
64,62,17,9,8,646
64,63,3,2,1,0
64,64,44,24,20,1663.2
64,68,4,1,3,0
65,26,10,5,5,674
65,27,12,8,4,577.2
65,28,11,8,3,336.6
65,43,1,0,1,0
65,47,1,0,1,0
65,53,4,3,1,0
65,54,73,32,41,2839.7
65,55,36,14,22,1969.2
65,56,696,331,365,30972
65,57,208,106,102,8944
65,58,10,5,5,188
65,60,2,2,0,0
65,61,9,4,5,422.1
65,62,32,17,15,1296
65,63,26,14,12,1183
65,64,29,14,15,1299.2
65,73,4,1,3,0
65,123,3,1,2,0
66,24,5,4,1,293
66,25,8,3,5,347.2
66,28,7,1,6,223.3
66,45,9,5,4,404.1
66,46,4,2,2,0
66,47,18,10,8,788.4
66,52,4,1,3,0
66,53,51,29,22,2040
66,54,35,20,15,1414
66,55,179,82,97,7553.8
66,56,471,246,225,15919.8
66,57,17,9,8,737.8
66,62,1,1,0,0
66,124,3,1,2,0
67,4,4,3,1,0
67,25,7,4,3,392
67,45,4,3,1,0
67,51,1,1,0,0
67,52,10,5,5,344
67,53,76,48,28,3275.6
67,55,155,87,68,6355
67,56,44,22,22,1777.6
67,57,11,4,7,310.2
67,58,4,2,2,0
67,123,5,3,2,164
67,124,2,1,1,0
68,4,1,1,0,0
68,25,18,8,10,1038.6
68,26,6,3,3,274.2
68,51,17,10,7,707.2
68,52,29,17,12,1461.6
68,53,96,51,45,3888
68,55,26,13,13,1177.8
68,56,47,18,29,2152.6
68,57,31,20,11,1029.2
68,58,1,1,0,0
68,123,3,1,2,0
69,24,8,4,4,343.2
69,25,19,10,9,1046.9
69,26,4,2,2,0
69,52,65,29,36,2587
69,53,30,14,16,1335
69,54,11,6,5,458.7
69,55,10,5,5,429
69,56,3,1,2,0
69,57,3,1,2,0
69,62,2,1,1,0
69,121,2,1,1,0
69,122,5,3,2,120
70,23,2,2,0,0
70,24,32,18,14,1811.2
70,51,9,5,4,389.7
70,52,71,35,36,2570.2
70,53,43,23,20,1861.9
70,54,10,5,5,391
70,59,2,0,2,0
70,122,4,2,2,0
71,22,2,1,1,0
71,51,35,20,15,1571.5
71,52,47,24,23,1922.3
71,53,231,117,114,9216.9
71,54,99,49,50,3623.4
71,121,1,0,1,0
71,122,23,14,9,1177.6
71,123,6,5,1,273
71,124,3,2,1,0
72,21,5,4,1,158
72,22,8,5,3,380
72,51,46,21,25,1858.4
72,52,23,10,13,722.2
72,53,159,90,69,5247
72,121,2,1,1,0
72,122,9,7,2,415.8
72,123,8,3,5,320
72,124,7,4,3,336.7
73,21,5,3,2,271
73,22,1,1,0,0
73,35,3,1,2,0
73,50,12,8,4,333.6
73,51,12,4,8,457.2
73,52,19,12,7,583.3
73,53,61,31,30,2415.6
73,54,19,9,10,951.9
73,55,4,2,2,0
73,119,5,2,3,321
73,120,13,7,6,620.1
73,121,26,17,9,1154.4
73,122,9,5,4,461.7
74,21,47,21,26,2072.7
74,22,6,4,2,343.8
74,23,1,1,0,0
74,49,11,7,4,435.6
74,50,28,10,18,988.4
74,51,43,26,17,1707.1
74,52,171,72,99,10260
74,53,35,19,16,1792
74,54,8,4,4,362.4
74,56,5,4,1,208
74,117,4,2,2,0
74,118,16,8,8,648
74,119,3,1,2,0
74,120,25,13,12,1275
74,121,6,3,3,157.8
74,122,11,7,4,380.6
74,123,2,2,0,0
75,20,3,1,2,0
75,21,13,7,6,652.6
75,23,1,1,0,0
75,32,3,2,1,0
75,46,5,1,4,144
75,47,11,7,4,470.8
75,48,26,14,12,1099.8
75,49,7,4,3,293.3
75,50,319,159,160,12951.4
75,51,233,108,125,10368.5
75,52,41,20,21,1939.3
75,53,32,18,14,1724.8
75,54,9,5,4,297
75,55,25,13,12,975
75,56,12,8,4,405.6
75,117,8,4,4,295.2
75,118,4,2,2,0
75,119,15,7,8,468
75,120,29,16,13,1513.8
75,122,1,1,0,0
76,18,12,7,5,594
76,19,33,20,13,1686.3
76,20,16,8,8,766.4
76,45,2,1,1,0
76,46,1,1,0,0
76,47,38,19,19,1546.6
76,48,40,20,20,2132
76,49,24,9,15,900
76,50,81,38,43,3410.1
76,51,45,19,26,1993.5
76,52,46,24,22,1619.2
76,53,5,3,2,188
76,117,19,11,8,836
76,118,8,5,3,439.2
76,119,5,3,2,178
76,120,10,6,4,295
77,17,2,1,1,0
77,18,5,1,4,144
77,19,22,10,12,961.4
77,40,1,1,0,0
77,41,2,2,0,0
77,46,3,1,2,0
77,47,15,8,7,672
77,48,136,62,74,6337.6
77,49,129,63,66,5250.3
77,50,39,18,21,1684.8
77,51,31,13,18,1729.8
77,52,5,2,3,170
77,116,1,1,0,0
78,10,2,1,1,0
78,14,9,6,3,413.1
78,15,17,9,8,953.7
78,16,10,6,4,503
78,17,10,5,5,364
78,47,20,8,12,892
78,48,54,28,26,1954.8
78,49,6,4,2,255
78,50,17,8,9,630.7
78,51,10,6,4,336
78,57,18,11,7,642.6
78,58,11,6,5,557.7
78,59,29,19,10,1064.3
78,60,5,3,2,124
78,61,17,10,7,627.3
78,62,4,1,3,0
78,63,10,6,4,380
78,115,1,0,1,0
78,117,5,2,3,163
79,13,7,4,3,277.2
79,14,37,21,16,1602.1
79,15,57,32,25,2348.4
79,16,20,9,11,886
79,47,4,3,1,0
79,48,54,29,25,2111.4
79,50,8,6,2,244.8
79,51,17,8,9,620.5
79,56,22,11,11,847
79,57,7,4,3,273
79,115,18,12,6,815.4
79,116,13,4,9,539.5
80,10,6,2,4,241.2
80,12,3,3,0,0
80,13,10,5,5,249
80,14,14,7,7,387.8
80,16,7,3,4,384.3
80,23,2,0,2,0
80,26,4,3,1,0
80,27,1,0,1,0
80,48,5,4,1,292
80,49,44,25,19,2068
80,50,62,32,30,2529.6
80,51,7,5,2,287.7
80,53,3,2,1,0
80,54,2,1,1,0
80,55,9,4,5,387
80,56,16,8,8,659.2
80,59,2,1,1,0
80,67,3,2,1,0
80,108,13,6,7,656.5
80,111,2,1,1,0
80,115,4,2,2,0
80,116,30,18,12,1326
81,9,3,0,3,0
81,10,30,17,13,1527
81,11,18,7,11,604.8
81,12,32,16,16,1193.6
81,13,2,0,2,0
81,19,6,3,3,273
81,26,21,12,9,875.7
81,47,3,1,2,0
81,48,2,1,1,0
81,49,20,18,2,766
81,50,37,20,17,1565.1
81,51,6,4,2,162
81,52,18,9,9,653.4
81,53,10,6,4,251
81,54,37,19,18,1291.3
81,55,24,12,12,1118.4
81,101,16,10,6,524.8
81,108,1,1,0,0
81,111,13,8,5,378.3
81,112,5,2,3,212
81,113,2,1,1,0
81,115,9,7,2,320.4
81,116,3,2,1,0
82,5,7,5,2,282.8
82,6,7,5,2,368.2
82,7,5,2,3,339
82,8,23,12,11,1363.9
82,9,15,8,7,826.5
82,10,154,70,84,8100.4
82,11,74,38,36,3581.6
82,12,8,3,5,426.4
82,17,1,1,0,0
82,18,35,18,17,1242.5
82,19,31,17,14,1525.2
82,20,17,8,9,698.7
82,25,2,0,2,0
82,47,3,2,1,0
82,49,39,21,18,1829.1
82,50,86,44,42,3061.6
82,51,13,8,5,561.6
82,52,9,3,6,322.2
82,53,6,1,5,265.2
82,56,7,4,3,263.2
82,95,3,1,2,0
82,101,2,1,1,0
82,105,5,3,2,228
82,112,1,1,0,0
82,113,5,1,4,215
82,115,205,104,101,9594
82,116,50,26,24,2165
83,3,7,4,3,233.8
83,4,9,4,5,432
83,5,22,9,13,1185.8
83,6,15,9,6,676.5
83,7,29,16,13,1336.9
83,8,18,8,10,696.6
83,9,49,24,25,2151.1
83,10,173,81,92,7802.3
83,11,317,148,169,13377.4
83,12,7,5,2,363.3
83,15,17,7,10,606.9
83,16,28,14,14,1257.2
83,17,27,16,11,864
83,18,35,18,17,1690.5
83,19,59,34,25,2006
83,20,35,14,21,1396.5
83,21,7,3,4,163.1
83,47,3,2,1,0
83,48,10,6,4,444
83,49,35,17,18,1543.5
83,50,30,18,12,1341
83,58,2,1,1,0
83,95,4,2,2,0
83,96,6,1,5,234
83,97,12,6,6,435.6
83,98,2,1,1,0
83,99,7,4,3,209.3
83,100,7,5,2,240.1
83,103,16,7,9,449.6
83,104,5,4,1,162
83,113,4,1,3,0
83,114,17,7,10,533.8
83,115,289,127,162,13583
83,116,18,10,8,777.6
84,2,3,2,1,0
84,3,18,9,9,829.8
84,4,24,9,15,844.8
84,5,3,1,2,0
84,6,4,2,2,0
84,7,6,3,3,265.2
84,9,4,3,1,0
84,10,39,20,19,1482
84,11,5,2,3,124
84,12,21,10,11,806.4
84,13,5,4,1,131
84,14,2,1,1,0
84,15,28,15,13,1584.8
84,16,43,19,24,1904.9
84,17,69,38,31,2180.4
84,18,51,29,22,2361.3
84,19,26,12,14,1146.6
84,20,69,38,31,2877.3
84,21,6,2,4,252
84,33,2,1,1,0
84,37,11,5,6,693
84,38,2,1,1,0
84,39,4,1,3,0
84,41,6,3,3,291
84,46,9,4,5,214.2
84,48,185,92,93,8177
84,49,26,12,14,988
84,50,6,4,2,325.8
84,57,2,1,1,0
84,58,1,0,1,0
84,60,2,1,1,0
84,61,2,1,1,0
84,63,13,3,10,538.2
84,91,5,4,1,160
84,107,1,1,0,0
84,113,5,4,1,172
84,114,38,17,21,1607.4
84,115,10,4,6,598
84,116,3,2,1,0
85,2,6,4,2,172.2
85,3,33,16,17,1435.5
85,10,6,4,2,337.8
85,11,2,1,1,0
85,12,5,4,1,260
85,13,18,10,8,610.2
85,14,29,14,15,1360.1
85,15,9,7,2,458.1
85,16,69,31,38,2456.4
85,17,26,14,12,1118
85,18,38,20,18,1444
85,19,8,5,3,234.4
85,20,50,28,22,2510
85,21,12,6,6,555.6
85,22,27,14,13,936.9
85,23,3,3,0,0
85,34,15,13,2,567
85,36,8,3,5,364
85,37,10,4,6,310
85,40,22,10,12,833.8
85,42,16,8,8,606.4
85,43,1,1,0,0
85,44,14,9,5,753.2
85,45,17,6,11,586.5
85,46,17,6,11,589.9
85,47,567,265,302,25118.1
85,48,315,153,162,13954.5
85,49,5,2,3,149
85,60,1,0,1,0
85,113,17,9,8,654.5
85,114,84,42,42,3813.6
85,115,28,13,15,924
86,2,9,4,5,354.6
86,10,3,2,1,0
86,11,17,8,9,792.2
86,12,41,20,21,1504.7
86,13,93,47,46,3320.1
86,14,63,35,28,2608.2
86,15,55,30,25,2117.5
86,16,56,29,27,2032.8
86,17,53,26,27,2464.5
86,18,30,16,14,1305
86,20,51,34,17,1713.6
86,21,146,67,79,5767
86,22,18,10,8,745.2
86,23,16,9,7,686.4
86,35,5,3,2,224
86,36,16,11,5,694.4
86,37,24,13,11,1221.6
86,38,40,18,22,1132
86,39,16,6,10,481.6
86,40,20,10,10,938
86,41,23,12,11,811.9
86,42,8,3,5,300.8
86,44,2,2,0,0
86,45,14,8,6,617.4
86,46,150,74,76,6555
86,47,143,72,71,6163.3
86,48,52,25,27,2111.2
86,49,81,39,42,3717.9
86,54,2,1,1,0
86,55,5,2,3,270
86,112,7,3,4,238.7
86,113,21,12,9,1146.6
86,114,18,11,7,720
87,1,5,3,2,195
87,2,23,14,9,970.6
87,12,34,15,19,1424.6
87,13,353,170,183,14720.1
87,14,334,181,153,12825.6
87,15,38,22,16,1535.2
87,16,25,16,9,1067.5
87,17,8,5,3,452.8
87,20,2,1,1,0
87,21,25,11,14,1007.5
87,22,16,10,6,758.4
87,23,1,1,0,0
87,28,3,2,1,0
87,33,6,3,3,211.2
87,34,2,1,1,0
87,35,31,17,14,1196.6
87,36,82,45,37,2935.6
87,37,49,28,21,2097.2
87,38,40,16,24,1828
87,39,230,116,114,8993
87,40,8,4,4,264.8
87,42,8,3,5,340.8
87,43,40,22,18,1444
87,44,19,9,10,1016.5
87,45,26,11,15,1079
87,46,25,12,13,1100
87,47,8,3,5,371.2
87,50,2,1,1,0
87,88,1,1,0,0
87,113,18,9,9,743.4
87,114,3,1,2,0
88,1,21,14,7,894.6
88,2,18,11,7,489.6
88,11,11,3,8,446.6
88,12,38,20,18,1630.2
88,13,177,96,81,7752.6
88,14,10,6,4,350
88,21,5,1,4,157
88,30,9,5,4,189.9
88,31,5,3,2,167
88,32,19,10,9,790.4
88,33,1,1,0,0
88,34,5,2,3,198
88,35,5,2,3,261
88,36,130,59,71,4784
88,37,69,33,36,2794.5
88,38,301,140,161,15983.1
88,39,186,93,93,8481.6
88,40,8,5,3,443.2
88,41,10,4,6,444
88,42,21,10,11,728.7
88,43,34,18,16,1298.8
88,44,7,5,2,373.1
88,45,21,11,10,787.5
88,56,1,1,0,0
88,87,7,3,4,368.9
88,113,18,11,7,957.6
88,114,8,3,5,420
89,0,22,12,10,750.2
89,1,4,1,3,0
89,2,2,1,1,0
89,9,1,1,0,0
89,10,3,2,1,0
89,11,30,16,14,1164
89,12,20,8,12,708
89,13,50,25,25,2060
89,14,14,7,7,554.4
89,15,7,2,5,172.9
89,19,7,5,2,317.1
89,20,13,9,4,487.5
89,21,53,28,25,2162.4
89,22,6,4,2,211.8
89,29,11,7,4,501.6
89,30,25,12,13,967.5
89,31,21,11,10,919.8
89,32,37,18,19,1805.6
89,33,47,20,27,1461.7
89,34,36,16,20,1378.8
89,35,67,35,32,2800.6
89,36,6,4,2,342
89,37,4,2,2,0
89,38,12,7,5,616.8
89,39,9,3,6,309.6
89,40,31,15,16,1388.8
89,42,4,2,2,0
89,113,4,3,1,0
90,0,34,19,15,1404.2
90,1,23,11,12,1067.2
90,8,22,12,10,1001
90,9,16,10,6,777.6
90,10,12,8,4,646.8
90,11,551,276,275,22756.3
90,12,313,141,172,14335.4
90,13,90,45,45,3852
90,14,36,22,14,1519.2
90,15,9,4,5,309.6
90,18,1,1,0,0
90,19,31,15,16,1274.1
90,20,31,14,17,1181.1
90,21,64,34,30,2758.4
90,22,9,4,5,411.3
90,23,2,1,1,0
90,25,5,3,2,150
90,26,12,8,4,433.2
90,27,7,3,4,427.7
90,28,28,14,14,1142.4
90,29,17,11,6,890.8
90,31,41,22,19,1689.2
90,32,12,5,7,357.6
90,33,19,11,8,948.1
90,34,36,16,20,1382.4
90,40,37,18,19,1579.9
90,53,1,0,1,0
90,114,2,2,0,0
90,115,8,5,3,304
90,116,1,1,0,0
91,0,89,51,38,3586.7
91,4,1,1,0,0
91,5,2,1,1,0
91,6,4,4,0,0
91,7,9,6,3,404.1
91,8,39,21,18,1872
91,9,26,14,12,891.8
91,10,62,31,31,2374.6
91,11,266,138,128,8857.8
91,12,38,20,18,1656.8
91,13,51,22,29,1836
91,14,10,4,6,549
91,18,5,3,2,206
91,19,16,8,8,534.4
91,20,5,3,2,306
91,21,43,19,24,1784.5
91,22,12,7,5,499.2
91,23,20,10,10,666
91,24,16,7,9,704
91,25,7,4,3,394.8
91,27,10,6,4,407
91,30,36,20,16,1494
91,31,26,16,10,954.2
91,32,7,3,4,359.1
91,33,6,3,3,343.2
91,40,25,14,11,1107.5
91,78,10,5,5,442
91,85,3,1,2,0
91,115,11,5,6,517
91,116,22,11,11,730.4
91,117,10,6,4,282
92,0,33,16,17,1237.5
92,4,19,8,11,963.3
92,5,16,7,9,590.4
92,6,10,5,5,408
92,7,18,8,10,734.4
92,8,72,38,34,2541.6
92,9,86,44,42,3465.8
92,10,35,18,17,1337
92,11,60,25,35,2130
92,12,28,16,12,1086.4
92,13,10,6,4,382
92,18,9,3,6,370.8
92,19,10,4,6,460
92,20,7,4,3,221.2
92,21,25,15,10,1157.5
92,22,367,175,192,15817.7
92,23,461,239,222,18993.2
92,24,31,20,11,1224.5
92,25,50,26,24,2090
92,26,57,25,32,2416.8
92,27,17,8,9,649.4
92,28,16,6,10,668.8
92,29,5,3,2,122
92,31,5,2,3,181
92,32,7,4,3,350
92,39,12,6,6,513.6
92,40,3,2,1,0
92,50,11,7,4,380.6
92,75,7,3,4,217.7
92,76,1,1,0,0
92,77,3,2,1,0
92,83,13,6,7,569.4
92,84,5,3,2,167
92,116,46,19,27,1909
92,117,26,16,10,936
93,4,32,16,16,1168
93,5,13,8,5,655.2
93,6,71,36,35,3045.9
93,7,5,1,4,104
93,8,74,36,38,3078.4
93,9,47,23,24,2190.2
93,10,53,28,25,1971.6
93,11,3,2,1,0
93,18,7,2,5,272.3
93,20,5,3,2,250
93,21,58,29,29,2389.6
93,22,73,40,33,3409.1
93,23,42,24,18,1457.4
93,24,40,19,21,1652
93,25,11,5,6,458.7
93,26,12,6,6,567.6
93,27,14,9,5,691.6
93,28,22,12,10,858
93,29,6,4,2,235.2
93,32,3,2,1,0
93,39,20,12,8,634
93,80,26,10,16,832
93,81,8,2,6,267.2
93,82,20,12,8,984
93,83,2,1,1,0
93,116,2,1,1,0
93,117,12,8,4,495.6
93,118,14,9,5,442.4
94,1,4,2,2,0
94,3,48,24,24,1468.8
94,4,146,78,68,5927.6
94,5,23,13,10,880.9
94,6,24,14,10,1135.2
94,8,5,2,3,299
94,17,16,10,6,532.8
94,18,1,1,0,0
94,19,22,13,9,926.2
94,22,6,3,3,283.2
94,23,20,7,13,902
94,24,10,6,4,491
94,32,6,2,4,207
94,33,8,5,3,351.2
94,38,4,3,1,0
94,39,44,23,21,1540
94,117,7,4,3,310.8
94,118,10,5,5,369
95,0,3,1,2,0
95,1,16,9,7,702.4
95,2,23,15,8,855.6
95,3,226,123,103,6870.4
95,4,289,140,149,11068.7
95,5,51,28,23,2070.6
95,6,40,18,22,1924
95,7,6,4,2,370.8
95,18,30,14,16,1245
95,19,45,24,21,1669.5
95,38,26,15,11,1144
95,48,7,4,3,469
95,71,3,2,1,0
95,119,8,4,4,270.4
96,0,22,13,9,928.4
96,1,52,27,25,1861.6
96,2,6,2,4,219
96,3,10,6,4,345
96,4,109,56,53,4697.9
96,5,220,113,107,8228
96,6,244,124,120,9589.2
96,7,55,32,23,2315.5
96,8,6,3,3,232.2
96,9,2,1,1,0
96,16,25,10,15,1012.5
96,17,52,24,28,2163.2
96,18,60,35,25,2436
96,19,57,27,30,2057.7
96,35,1,1,0,0
96,38,5,2,3,135
96,39,9,7,2,275.4
96,118,13,9,4,365.3
96,119,18,9,9,702
97,0,57,31,26,2371.2
97,1,34,22,12,1506.2
97,2,23,11,12,752.1
97,3,46,24,22,1858.4
97,4,116,58,58,4454.4
97,5,73,41,32,2825.1
97,6,288,144,144,10886.4
97,7,35,17,18,1256.5
97,8,29,16,13,1322.4
97,9,46,23,23,1849.2
97,10,11,5,6,459.8
97,15,13,6,7,513.5
97,16,46,25,21,1899.8
97,17,20,8,12,622
97,18,48,25,23,2083.2
97,19,33,18,15,1524.6
97,20,9,4,5,394.2
97,82,2,2,0,0
97,83,1,1,0,0
97,119,4,2,2,0
97,120,1,1,0,0
97,121,1,1,0,0
98,0,337,154,183,14019.2
98,1,846,407,439,35109
98,2,523,229,294,25574.7
98,3,84,41,43,3704.4
98,9,31,17,14,1196.6
98,10,33,23,10,1673.1
98,11,14,7,7,687.4
98,12,14,8,6,512.4
98,13,28,14,14,1055.6
98,14,110,57,53,3322
98,15,36,17,19,982.8
98,16,161,76,85,7341.6
98,17,229,109,120,9068.4
98,18,72,38,34,2836.8
98,19,17,8,9,749.7
98,72,2,1,1,0
98,119,4,2,2,0
98,120,14,5,9,523.6
99,0,2353,1075,1278,105649.7
99,1,2127,998,1129,96353.1
99,2,1846,877,969,71071
99,3,169,93,76,6810.7
99,10,3,2,1,0
99,11,18,10,8,518.4
99,12,21,12,9,663.6
99,13,163,85,78,5851.7
99,14,944,482,462,36910.4
99,15,255,129,126,11245.5
99,16,76,39,37,3701.2
99,17,41,22,19,1594.9
99,18,8,4,4,367.2
99,19,5,3,2,153
99,72,2,2,0,0
99,73,17,8,9,698.7
99,82,2,1,1,0
99,121,3,2,1,0
100,0,952,453,499,39412.8
100,1,730,353,377,31317
100,2,594,299,295,24591.6
100,3,140,79,61,6160
100,4,1,0,1,0
100,10,56,28,28,2430.4
100,11,76,39,37,3085.6
100,12,100,59,41,3610
100,13,23,14,9,945.3
100,14,78,38,40,2714.4
100,15,81,41,40,3434.4
100,16,24,12,12,912
100,73,16,8,8,694.4
100,81,1,1,0,0
100,121,4,2,2,0
101,0,23,11,12,795.8
101,1,22,9,13,939.4
101,2,108,55,53,3650.4
101,3,54,26,28,2435.4
101,14,7,4,3,331.1
101,15,12,6,6,428.4
101,74,5,4,1,146
101,117,8,4,4,162.4
101,120,5,2,3,340
102,2,33,18,15,1313.4
102,3,16,9,7,929.6
102,11,3,1,2,0
102,16,1,1,0,0
102,74,3,2,1,0
102,120,3,2,1,0
102,121,5,2,3,156
103,2,22,11,11,930.6
103,3,7,4,3,263.9
103,11,1,1,0,0
103,12,3,2,1,0
103,16,3,2,1,0
103,74,2,2,0,0
103,75,1,0,1,0
103,125,9,5,4,351.9
104,2,14,8,6,548.8
104,12,1,0,1,0
104,121,4,2,2,0
104,125,12,8,4,667.2
104,126,5,4,1,118
105,74,6,3,3,205.2
106,74,19,10,9,913.9
106,75,4,2,2,0
106,119,17,7,10,409.7
106,120,7,4,3,244.3
106,122,1,1,0,0
107,74,5,2,3,285
107,75,5,3,2,273
107,108,1,1,0,0
107,119,1,1,0,0
107,120,2,0,2,0
108,1,3,2,1,0
108,5,1,1,0,0
108,6,20,9,11,892
108,7,5,2,3,127
108,74,6,2,4,289.2
108,119,7,4,3,322.7
109,0,33,20,13,1643.4
109,1,6,2,4,204
109,65,2,1,1,0
109,74,4,3,1,0
109,109,2,2,0,0
109,118,4,2,2,0
109,120,2,1,1,0
110,0,46,24,22,1996.4
110,54,1,1,0,0
110,109,8,6,2,379.2
110,118,1,1,0,0
111,3,17,9,8,652.8
111,53,4,2,2,0
111,109,14,7,7,540.4
111,110,17,9,8,476
111,111,48,24,24,2092.8
111,112,22,12,10,919.6
111,113,3,1,2,0
111,116,4,1,3,0
111,123,1,1,0,0
112,1,7,3,4,214.9
112,2,3,2,1,0
112,3,27,14,13,1020.6
112,64,3,1,2,0
112,75,9,3,6,335.7
112,108,3,1,2,0
112,110,25,11,14,1190
112,111,98,53,45,3949.4
112,112,86,50,36,3440
112,113,4,3,1,0
112,114,20,9,11,852
112,115,4,3,1,0
112,116,27,11,16,1098.9
113,4,4,2,2,0
113,65,2,1,1,0
113,75,4,2,2,0
113,108,2,1,1,0
113,110,18,9,9,1076.4
113,111,18,12,6,813.6
113,112,117,56,61,4305.6
113,113,35,17,18,1351
113,114,7,1,6,133
114,14,37,21,16,1387.5
114,74,4,1,3,0
114,108,2,0,2,0
114,109,12,7,5,440.4
114,110,110,52,58,3674
114,111,17,8,9,1011.5
114,112,89,45,44,3052.7
114,113,3,1,2,0
114,120,1,1,0,0
114,121,1,0,1,0
115,74,5,2,3,163
115,106,4,2,2,0
115,107,30,18,12,1143
115,108,39,21,18,1665.3
115,109,7,3,4,273
115,110,92,47,45,3192.4
115,111,26,15,11,1237.6
115,112,38,16,22,1816.4
115,113,6,4,2,294
115,114,19,11,8,820.8
115,116,15,9,6,382.5
115,117,18,9,9,547.2
115,118,7,3,4,261.1
115,120,9,4,5,255.6
115,121,10,6,4,285
115,122,2,1,1,0
116,72,6,3,3,205.2
116,106,51,29,22,1856.4
116,108,10,6,4,379
116,109,202,100,102,8403.2
116,110,339,149,190,15695.7
116,111,44,18,26,1874.4
116,112,26,14,12,1125.8
116,113,5,2,3,212
116,114,13,7,6,412.1
116,115,3,1,2,0
116,116,7,3,4,375.2
116,117,13,6,7,578.5
116,118,4,2,2,0
116,119,31,16,15,1274.1
116,120,62,29,33,2653.6
116,122,5,1,4,128
117,107,9,5,4,359.1
117,108,63,27,36,2677.5
117,109,18,10,8,896.4
117,112,3,1,2,0
117,119,16,8,8,772.8
117,120,15,8,7,642
117,121,11,6,5,346.5
117,122,15,6,9,679.5
117,123,17,9,8,564.4
117,124,14,7,7,631.4
117,127,16,9,7,601.6
118,70,3,1,2,0
118,106,16,7,9,588.8
118,107,42,23,19,1860.6
118,108,8,4,4,260
118,113,1,1,0,0
118,120,6,3,3,196.8
118,121,13,5,8,525.2
118,122,58,31,27,2169.2
118,123,3,2,1,0
118,125,7,4,3,231.7
118,126,71,33,38,2477.9
118,127,102,56,46,3692.4
119,40,1,1,0,0
119,68,2,1,1,0
119,69,1,1,0,0
119,104,6,2,4,364.2
119,105,16,7,9,604.8
119,106,18,10,8,590.4
119,112,3,2,1,0
119,123,5,3,2,167
119,124,1,1,0,0
119,125,14,7,7,553
119,126,66,32,34,2065.8
119,127,28,12,16,1234.8
120,68,3,2,1,0
120,102,14,7,7,469
120,103,5,2,3,151
120,126,9,4,5,407.7
120,127,24,11,13,864
121,1,1,1,0,0
121,67,1,0,1,0
121,68,4,2,2,0
121,101,6,2,4,259.2
121,102,1,1,0,0
121,126,3,1,2,0
121,127,33,16,17,1405.8
122,1,2,1,1,0
122,100,14,7,7,581
122,101,11,8,3,513.7
122,125,24,12,12,1005.6
122,126,54,29,25,2170.8
122,127,55,28,27,2112
123,51,1,1,0,0
123,53,1,1,0,0
123,66,17,7,10,751.4
123,67,75,45,30,3667.5
123,100,42,23,19,1638
123,101,2,1,1,0
123,126,6,2,4,157.8
123,127,107,46,61,4387
124,65,15,8,7,789
124,66,11,7,4,511.5
124,67,8,3,5,484
124,99,10,3,7,398
124,100,6,2,4,216
124,109,11,7,4,423.5
124,110,15,6,9,745.5
124,111,31,15,16,1029.2
124,112,57,31,26,2439.6
124,113,18,10,8,712.8
124,114,11,6,5,381.7
124,120,7,3,4,301.7
124,126,621,295,326,22977
124,127,277,120,157,12381.9
125,54,3,1,2,0
125,57,10,7,3,539
125,65,4,3,1,0
125,66,2,1,1,0
125,75,2,1,1,0
125,77,8,4,4,316
125,98,2,1,1,0
125,99,7,2,5,207.9
125,107,3,2,1,0
125,108,25,12,13,855
125,109,77,41,36,3126.2
125,110,25,12,13,1195
125,111,31,15,16,1267.9
125,112,33,17,16,1343.1
125,113,8,2,6,328.8
125,126,259,141,118,8365.7
125,127,784,377,407,32928
126,53,1,1,0,0
126,54,12,6,6,484.8
126,55,9,5,4,302.4
126,56,12,7,5,368.4
126,58,6,3,3,337.2
126,59,2,2,0,0
126,60,4,3,1,0
126,63,5,2,3,281
126,64,1,1,0,0
126,78,4,2,2,0
126,97,1,1,0,0
126,105,7,4,3,168.7
126,106,11,6,5,420.2
126,107,10,4,6,266
126,108,14,7,7,630
126,109,13,7,6,652.6
126,127,17,10,7,489.6
127,53,4,1,3,0
127,54,2,1,1,0
127,59,3,2,1,0
127,78,1,0,1,0
127,79,14,7,7,543.2
127,96,2,0,2,0
127,105,6,2,4,273
127,106,4,2,2,0