x,y,p,m,f,ta
0,9,19,11,8,689.7
0,10,53,22,31,2220.7
0,12,9,6,3,375.3
0,86,20,13,7,830
0,92,15,8,7,534
0,93,9,6,3,415.8
0,94,37,23,14,1520.7
1,10,11,5,6,258.5
1,11,14,8,6,624.4
1,12,5,2,3,250
1,13,11,4,7,642.4
1,86,12,7,5,517.2
1,87,16,8,8,617.6
1,91,3,2,1,0
1,92,14,5,9,606.2
1,93,8,6,2,260
1,94,8,4,4,338.4
2,13,22,11,11,924
2,86,15,7,8,886.5
2,87,37,19,18,1528.1
2,91,33,18,15,1422.3
2,92,7,4,3,452.2
2,93,4,2,2,0
3,12,11,7,4,589.6
3,13,15,7,8,766.5
3,14,13,7,6,591.5
3,86,3,2,1,0
3,87,45,22,23,2178
3,90,13,7,6,533
3,92,9,4,5,468.9
4,13,36,15,21,1630.8
4,14,39,23,16,1692.6
4,87,12,8,4,606
4,88,139,74,65,5699
4,89,259,122,137,10800.3
4,90,4,2,2,0
5,11,1,1,0,0
5,13,2,1,1,0
5,14,60,30,30,2436
5,15,15,4,11,679.5
5,88,330,163,167,15180
5,89,81,44,37,3231.9
6,11,13,7,6,605.8
6,12,24,10,14,1132.8
6,13,22,11,11,1014.2
6,14,5,2,3,206
6,15,15,8,7,727.5
6,88,61,28,33,2232.6
6,89,25,12,13,755
7,13,5,2,3,325
7,14,7,3,4,303.8
7,89,51,28,23,2101.2
7,90,6,4,2,166.8
7,91,3,2,1,0
8,11,24,14,10,1144.8
8,12,14,6,8,624.4
8,13,7,3,4,226.8
8,89,50,20,30,1905
8,90,19,11,8,986.1
8,91,14,8,6,536.2
8,127,1,0,1,0
9,9,4,2,2,0
9,10,3,2,1,0
9,12,8,4,4,352.8
9,14,3,1,2,0
9,90,13,6,7,627.9
9,91,9,4,5,288.9
9,127,9,6,3,342.9
10,8,10,5,5,418
10,9,17,7,10,907.8
10,10,25,13,12,1432.5
10,11,14,7,7,705.6
10,12,38,24,14,1527.6
10,23,16,8,8,676.8
10,90,13,8,5,579.8
10,91,20,11,9,750
10,127,9,5,4,234
11,8,29,16,13,1267.3
11,9,117,64,53,4329
11,10,36,20,16,1468.8
11,11,21,13,8,1207.5
11,23,4,3,1,0
11,91,53,29,24,2157.1
11,92,10,8,2,349
11,126,3,1,2,0
11,127,5,2,3,98
12,5,1,1,0,0
12,7,2,1,1,0
12,8,22,12,10,1029.6
12,9,41,22,19,1902.4
12,10,34,19,15,1356.6
12,11,15,6,9,703.5
12,22,5,4,1,223
12,23,4,3,1,0
12,31,1,0,1,0
12,89,17,7,10,589.9
12,90,30,15,15,1227
12,91,41,22,19,1709.7
12,92,5,3,2,185
12,125,5,3,2,272
12,126,7,3,4,252
13,7,29,16,13,1302.1
13,8,14,8,6,674.8
13,9,6,2,4,295.8
13,10,33,20,13,1237.5
13,21,13,8,5,665.6
13,89,33,19,14,1531.2
13,91,39,20,19,1411.8
13,92,22,12,10,990
13,124,10,5,5,566
13,125,18,8,10,707.4
13,126,1,0,1,0
14,7,14,10,4,680.4
14,8,1,0,1,0
14,9,24,12,12,1130.4
14,10,18,9,9,878.4
14,13,2,0,2,0
14,21,18,9,9,937.8
14,49,5,3,2,111
14,89,33,17,16,1560.9
14,91,11,6,5,742.5
14,92,3,2,1,0
14,122,13,6,7,542.1
14,123,27,14,13,1020.6
14,124,4,2,2,0
15,7,14,8,6,630
15,8,4,1,3,0
15,9,66,33,33,2455.2
15,10,4,4,0,0
15,12,1,1,0,0
15,20,12,4,8,495.6
15,21,50,25,25,1820
15,88,12,4,8,339.6
15,89,16,7,9,596.8
15,91,11,7,4,471.9
15,118,2,2,0,0
15,121,25,12,13,1225
15,122,49,27,22,1974.7
15,123,10,5,5,547
16,5,10,5,5,484
16,6,29,18,11,1334
16,7,14,7,7,526.4
16,8,13,6,7,598
16,9,6,2,4,403.2
16,12,9,5,4,323.1
16,13,2,1,1,0
16,18,10,5,5,274
16,19,24,12,12,715.2
16,20,36,18,18,1044
16,21,20,10,10,974
16,88,7,5,2,343
16,89,23,12,11,1120.1
16,91,20,12,8,884
16,120,46,24,22,1577.8
16,121,22,9,13,855.8
17,5,14,6,8,614.6
17,6,17,10,7,695.3
17,8,34,16,18,1489.2
17,13,9,6,3,249.3
17,17,9,4,5,550.8
17,18,12,4,8,352.8
17,20,10,4,6,399
17,21,114,57,57,4400.4
17,51,3,2,1,0
17,88,23,11,12,945.3
17,89,100,51,49,3990
17,91,9,5,4,549.9
17,119,36,22,14,1465.2
17,120,34,20,14,1431.4
18,2,18,7,11,676.8
18,3,15,9,6,736.5
18,4,7,4,3,235.2
18,5,18,7,11,768.6
18,6,36,22,14,1634.4
18,7,46,23,23,1789.4
18,8,9,2,7,522.9
18,11,2,1,1,0
18,12,4,2,2,0
18,13,26,15,11,982.8
18,16,4,3,1,0
18,17,15,9,6,649.5
18,18,2,1,1,0
18,19,33,13,20,1511.4
18,20,174,83,91,6855.6
18,21,56,30,26,2111.2
18,88,36,19,17,1648.8
18,89,78,42,36,3439.8
18,90,17,9,8,595
18,118,2,1,1,0
18,119,36,23,13,1702.8
18,120,20,12,8,820
19,0,9,7,2,404.1
19,1,29,12,17,1154.2
19,2,7,3,4,420.7
19,3,83,40,43,3087.6
19,4,58,26,32,2702.8
19,5,24,14,10,998.4
19,6,6,4,2,426
19,12,26,13,13,975
19,13,6,3,3,235.8
19,14,1,1,0,0
19,15,2,1,1,0
19,16,22,12,10,704
19,17,38,18,20,1789.8
19,88,38,23,15,2074.8
19,89,2,1,1,0
19,90,3,2,1,0
19,118,2,1,1,0
19,119,57,32,25,2405.4
19,120,4,2,2,0
20,0,17,8,9,831.3
20,1,22,12,10,822.8
20,2,51,26,25,1846.2
20,3,234,99,135,11583
20,4,14,6,8,648.2
20,11,3,1,2,0
20,12,5,3,2,188
20,13,5,3,2,178
20,14,22,13,9,880
20,15,40,15,25,1820
20,16,21,12,9,1050
20,88,40,21,19,1756
20,118,7,3,4,445.2
20,119,36,20,16,1299.6
21,0,12,4,8,499.2
21,1,41,21,20,1676.9
21,2,9,5,4,549
21,3,10,5,5,378
21,11,19,10,9,737.2
21,12,20,8,12,696
21,13,32,19,13,1382.4
21,14,41,18,23,1389.9
21,15,12,8,4,393.6
21,89,5,1,4,191
21,118,23,12,11,1078.7
21,119,23,12,11,989
22,0,33,16,17,1102.2
22,1,20,12,8,864
22,6,10,4,6,367
22,7,2,1,1,0
22,10,6,4,2,307.8
22,11,32,16,16,1196.8
22,14,1,1,0,0
22,87,21,12,9,850.5
22,89,5,2,3,157
22,115,5,3,2,168
22,117,3,2,1,0
22,118,30,13,17,873
23,0,11,7,4,338.8
23,5,8,3,5,290.4
23,6,57,27,30,2416.8
23,7,36,20,16,1702.8
23,10,89,53,36,3649
23,11,37,18,19,1272.8
23,83,2,1,1,0
23,87,15,7,8,633
23,88,7,5,2,277.2
23,89,2,1,1,0
23,117,12,5,7,465.6
23,118,206,89,117,10238.2
24,4,9,4,5,234
24,5,9,4,5,446.4
24,6,100,47,53,3510
24,7,1,0,1,0
24,8,13,7,6,639.6
24,9,104,45,59,6489.6
24,10,5,3,2,152
24,11,30,16,14,1155
24,12,5,2,3,213
24,62,2,1,1,0
24,87,11,5,6,422.4
24,88,5,1,4,119
24,89,2,1,1,0
24,116,7,3,4,319.9
24,117,8,6,2,276
24,118,54,27,27,2694.6
25,0,3,2,1,0
25,1,27,13,14,1147.5
25,2,44,25,19,1997.6
25,3,7,5,2,350.7
25,5,4,2,2,0
25,6,31,16,15,917.6
25,7,38,21,17,1816.4
25,8,99,48,51,4138.2
25,9,108,44,64,5443.2
25,10,1,1,0,0
25,11,29,14,15,1162.9
25,12,11,7,4,434.5
25,83,1,1,0,0
25,85,3,2,1,0
25,87,27,12,15,1306.8
25,88,1,0,1,0
25,89,5,4,1,111
25,118,28,15,13,1117.2
26,0,5,2,3,247
26,1,15,5,10,552
26,3,6,5,1,157.2
26,4,29,14,15,1597.9
26,5,40,20,20,1616
26,6,125,54,71,5550
26,7,157,78,79,7457.5
26,10,11,6,5,410.3
26,11,38,21,17,1497.2
26,12,4,2,2,0
26,85,19,10,9,744.8
26,86,1,1,0,0
26,87,58,31,27,1960.4
26,88,29,17,12,1447.1
26,96,4,3,1,0
26,97,2,1,1,0
26,116,16,9,7,556.8
26,117,3,1,2,0
26,118,31,14,17,1187.3
26,125,4,3,1,0
27,0,3,1,2,0
27,1,79,39,40,2488.5
27,2,60,32,28,2838
27,3,94,49,45,3543.8
27,4,32,17,15,1270.4
27,5,46,28,18,1688.2
27,6,1,0,1,0
27,85,22,12,10,1078
27,87,18,7,11,730.8
27,88,4,2,2,0
27,89,47,23,24,1518.1
27,90,6,2,4,178.2
27,96,12,7,5,621.6
27,115,8,6,2,376
27,116,18,9,9,802.8
27,117,7,4,3,245.7
27,118,59,28,31,2637.3
27,124,6,3,3,136.8
28,0,67,33,34,2807.3
28,1,104,55,49,4045.6
28,3,45,23,22,1840.5
28,4,4,3,1,0
28,83,3,1,2,0
28,84,5,3,2,201
28,85,3,2,1,0
28,87,1,1,0,0
28,88,18,10,8,675
28,89,35,23,12,1323
28,90,21,12,9,1047.9
28,94,10,7,3,470
28,95,20,9,11,1074
28,96,24,14,10,1027.2
28,97,20,10,10,626
28,115,15,7,8,628.5
28,116,2,1,1,0
28,117,27,13,14,1363.5
28,118,1,1,0,0
29,0,122,61,61,5185
29,1,24,11,13,1106.4
29,14,2,1,1,0
29,73,2,1,1,0
29,82,3,2,1,0
29,89,22,13,9,943.8
29,90,4,2,2,0
29,93,12,7,5,596.4
29,94,10,5,5,423
29,95,6,4,2,261
29,96,26,12,14,917.8
29,115,13,6,7,646.1
29,116,3,2,1,0
29,117,14,5,9,410.2
30,0,21,11,10,976.5
30,73,4,3,1,0
30,74,9,5,4,386.1
30,88,8,6,2,374.4
30,90,50,23,27,2070
30,92,16,8,8,630.4
30,93,11,5,6,491.7
30,113,5,3,2,150
30,115,13,9,4,534.3
30,116,7,5,2,252
31,9,5,2,3,183
31,73,21,13,8,800.1
31,74,25,13,12,1105
31,77,9,5,4,260.1
31,88,20,8,12,828
31,89,6,3,3,282
31,90,39,18,21,1540.5
31,92,22,9,13,1012
31,93,8,5,3,304
31,113,4,1,3,0
31,114,6,3,3,406.8
31,115,16,11,5,777.6
31,116,3,1,2,0
31,118,2,1,1,0
31,120,3,2,1,0
32,9,2,1,1,0
32,76,1,1,0,0
32,88,15,6,9,652.5
32,89,3,2,1,0
32,90,4,3,1,0
32,91,33,18,15,1442.1
32,92,37,16,21,1739
32,113,18,8,10,739.8
32,114,41,21,20,1586.7
32,115,21,10,11,760.2
33,74,3,1,2,0
33,88,8,6,2,395.2
33,89,109,50,59,4926.8
33,90,697,328,369,34083.3
33,91,115,64,51,4301
33,113,22,14,8,759
33,114,42,22,20,1528.8
33,115,4,2,2,0
34,88,16,8,8,664
34,89,52,26,26,2808
34,90,341,156,185,14560.7
34,91,80,43,37,3968
34,110,1,0,1,0
34,111,11,5,6,404.8
34,112,3,2,1,0
34,113,2,1,1,0
34,114,20,11,9,956
35,69,3,2,1,0
35,72,6,2,4,345
35,73,24,14,10,1087.2
35,74,9,7,2,537.3
35,75,3,2,1,0
35,77,1,1,0,0
35,88,6,3,3,85.8
35,89,40,22,18,1756
35,90,190,97,93,7391
35,91,18,8,10,833.4
35,110,5,2,3,125
35,111,19,9,10,579.5
35,112,1,1,0,0
35,113,34,16,18,1462
35,114,74,38,36,3108
36,68,3,2,1,0
36,73,5,3,2,267
36,74,37,20,17,1857.4
36,75,3,2,1,0
36,88,29,16,13,1229.6
36,89,11,7,4,545.6
36,90,28,15,13,1330
36,91,3,2,1,0
36,109,11,5,6,344.3
36,110,7,4,3,291.2
36,111,17,7,10,836.4
36,112,51,29,22,2126.7
36,113,15,8,7,687
36,114,33,17,16,1742.4
37,65,14,8,6,519.4
37,66,29,15,14,1328.2
37,67,13,8,5,767
37,71,3,2,1,0
37,73,6,5,1,165
37,74,2,1,1,0
37,75,12,7,5,643.2
37,87,16,9,7,638.4
37,88,43,24,19,1591
37,89,9,6,3,351.9
37,90,8,5,3,219.2
37,107,8,5,3,344
37,108,26,13,13,995.8
37,109,2,1,1,0
37,110,19,11,8,723.9
37,111,87,39,48,3523.5
37,112,441,222,219,19359.9
37,113,450,223,227,19035
38,65,19,13,6,625.1
38,66,2,1,1,0
38,74,6,3,3,291
38,75,32,17,15,1129.6
38,80,2,1,1,0
38,81,1,1,0,0
38,87,38,15,23,1835.4
38,88,52,27,25,1700.4
38,89,4,2,2,0
38,107,30,16,14,1071
38,108,52,31,21,2308.8
38,109,21,12,9,911.4
38,112,138,72,66,6306.6
38,113,89,47,42,3159.5
39,62,1,1,0,0
39,74,21,9,12,756
39,75,19,11,8,851.2
39,76,3,2,1,0
39,81,2,1,1,0
39,86,51,24,27,2055.3
39,87,62,32,30,2697
39,88,31,16,15,1515.9
39,89,17,10,7,809.2
39,105,7,4,3,287.7
39,106,34,18,16,1251.2
39,107,13,5,8,626.6
39,108,2,2,0,0
40,75,18,11,7,865.8
40,76,30,12,18,1356
40,85,13,8,5,587.6
40,86,27,14,13,1228.5
40,87,9,4,5,332.1
40,88,14,8,6,527.8
40,97,3,2,1,0
40,103,2,1,1,0
40,104,7,2,5,240.1
40,105,11,5,6,503.8
40,106,20,12,8,1012
40,107,8,3,5,236
41,75,17,8,9,712.3
41,76,19,9,10,737.2
41,77,22,11,11,1104.4
41,83,16,10,6,659.2
41,84,15,7,8,808.5
41,85,16,7,9,724.8
41,86,9,4,5,308.7
41,87,1,0,1,0
41,101,13,6,7,562.9
41,103,12,7,5,537.6
41,104,31,15,16,1410.5
41,105,30,18,12,1101
41,106,20,11,9,768
42,75,21,12,9,1121.4
42,76,77,37,40,3349.5
42,77,3,1,2,0
42,81,4,2,2,0
42,82,102,55,47,3886.2
42,83,192,91,101,7929.6
42,84,10,6,4,507
42,85,25,12,13,1112.5
42,86,1,1,0,0
42,87,4,2,2,0
42,97,9,4,5,234
42,99,13,7,6,618.8
42,100,12,6,6,735.6
42,101,169,81,88,8720.4
42,102,128,60,68,5926.4
42,103,85,32,53,5321
42,104,16,9,7,724.8
42,105,3,2,1,0
43,45,3,2,1,0
43,75,61,35,26,2799.9
43,76,272,127,145,12240
43,81,36,18,18,1371.6
43,82,75,39,36,2512.5
43,83,21,9,12,781.2
43,84,31,14,17,1109.8
43,85,19,13,6,830.3
43,87,2,1,1,0
43,96,4,3,1,0
43,97,17,10,7,771.8
43,98,31,14,17,1354.7
43,99,19,10,9,866.4
43,100,21,9,12,1018.5
43,101,34,16,18,1523.2
43,102,60,34,26,2466
43,103,29,15,14,1212.2
44,45,2,1,1,0
44,46,6,2,4,312
44,74,32,16,16,1462.4
44,75,62,28,34,2393.2
44,76,8,5,3,332.8
44,80,2,2,0,0
44,81,14,6,8,403.2
44,96,13,5,8,526.5
44,97,3,1,2,0
44,98,12,4,8,463.2
44,100,2,0,2,0
44,101,10,5,5,563
44,102,4,3,1,0
45,46,4,3,1,0
45,47,8,6,2,344
45,48,9,4,5,349.2
45,49,33,16,17,1263.9
45,73,13,9,4,750.1
45,74,33,20,13,1422.3
45,75,25,13,12,1025
45,80,21,10,11,823.2
45,86,3,1,2,0
45,94,6,2,4,171
45,95,24,16,8,1022.4
45,96,9,6,3,387
45,97,6,4,2,304.8
46,48,9,5,4,567.9
46,49,57,33,24,2445.3
46,50,54,26,28,2737.8
46,72,13,7,6,630.5
46,73,34,19,15,1336.2
46,74,2,1,1,0
46,79,3,2,1,0
46,80,1,1,0,0
46,93,9,4,5,413.1
46,94,63,30,33,2715.3
46,95,33,13,20,1336.5
46,116,3,2,1,0
47,2,1,1,0,0
47,47,1,0,1,0
47,49,15,9,6,643.5
47,50,38,19,19,1960.8
47,71,27,15,12,990.9
47,72,3,2,1,0
47,73,9,4,5,407.7
47,74,1,1,0,0
47,79,5,1,4,219
47,85,9,6,3,461.7
47,93,52,28,24,2511.6
47,94,15,8,7,601.5
47,95,3,2,1,0
48,43,13,7,6,613.6
48,44,2,2,0,0
48,49,12,7,5,796.8
48,50,2,1,1,0
48,51,43,22,21,2016.7
48,69,1,1,0,0
48,70,8,3,5,486.4
48,71,19,8,11,1008.9
48,72,7,3,4,279.3
48,73,1,1,0,0
48,78,10,5,5,311
48,79,6,4,2,253.8
48,83,11,5,6,400.4
48,84,22,12,10,1049.4
48,85,36,18,18,1436.4
48,91,6,2,4,139.2
48,92,6,3,3,397.2
48,93,6,3,3,208.2
49,43,3,2,1,0
49,49,12,5,7,355.2
49,51,17,9,8,836.4
49,52,9,5,4,503.1
49,53,2,1,1,0
49,54,3,2,1,0
49,69,33,17,16,1326.6
49,70,74,37,37,3307.8
49,71,10,6,4,458
49,78,13,7,6,448.5
49,79,17,6,11,669.8
49,83,12,5,7,453.6
49,84,85,42,43,3808
49,85,128,62,66,5990.4
49,87,2,1,1,0
49,88,11,7,4,412.5
49,89,4,1,3,0
49,90,27,13,14,1306.8
49,91,12,6,6,570
49,92,7,3,4,342.3
49,119,2,1,1,0
50,4,2,0,2,0
50,40,3,1,2,0
50,51,6,3,3,313.2
50,52,7,4,3,287
50,53,10,7,3,459
50,54,10,5,5,526
50,68,2,1,1,0
50,69,46,24,22,2093
50,70,22,13,9,924
50,71,14,8,6,487.2
50,79,14,6,8,770
50,82,3,2,1,0
50,84,37,18,19,1517
50,85,206,103,103,9084.6
50,86,141,73,68,5654.1
50,88,1,1,0,0
50,89,1,1,0,0
51,51,2,1,1,0
51,52,16,9,7,884.8
51,53,4,3,1,0
51,54,4,3,1,0
51,67,1,1,0,0
51,68,33,16,17,1834.8
51,69,25,16,9,1085
51,70,3,2,1,0
51,77,5,3,2,86
51,79,66,32,34,2534.4
51,84,12,5,7,496.8
51,85,9,5,4,419.4
51,119,5,4,1,112
52,37,3,2,1,0
52,53,21,8,13,774.9
52,54,5,2,3,237
52,67,6,3,3,282
52,68,2,2,0,0
52,77,41,20,21,1943.4
52,78,16,10,6,624
52,79,2,2,0,0
52,83,8,2,6,232
52,85,4,2,2,0
53,36,3,2,1,0
53,37,5,2,3,385
53,54,26,10,16,1040
53,55,23,13,10,1009.7
53,56,5,3,2,147
53,76,4,3,1,0
53,77,507,255,252,20381.4
53,78,52,26,26,1908.4
53,83,4,2,2,0
53,84,3,2,1,0
53,89,1,1,0,0
53,90,9,5,4,492.3
54,35,2,0,2,0
54,36,1,1,0,0
54,55,2,1,1,0
54,56,4,2,2,0
54,65,3,2,1,0
54,66,13,9,4,786.5
54,67,14,8,6,506.8
54,68,6,3,3,328.2
54,76,24,10,14,1332
54,77,165,79,86,6715.5
54,78,4,1,3,0
54,82,6,3,3,322.8
54,83,12,7,5,475.2
54,90,16,7,9,697.6
54,122,2,1,1,0
55,54,5,3,2,73
55,55,8,4,4,318.4
55,65,4,2,2,0
55,66,137,66,71,5096.4
55,67,7,5,2,333.2
55,68,15,7,8,781.5
55,69,15,7,8,762
55,70,1,1,0,0
55,71,37,21,16,1753.8
55,72,10,7,3,482
55,73,6,3,3,310.8
55,74,2,1,1,0
55,75,42,23,19,1507.8
55,76,637,292,345,28601.3
55,77,226,111,115,9785.8
55,78,5,3,2,136
55,81,6,3,3,328.2
55,82,14,8,6,455
55,83,4,2,2,0
56,33,5,1,4,149
56,54,11,5,6,555.5
56,55,6,1,5,207
56,65,36,16,20,1490.4
56,66,6,3,3,342
56,68,2,1,1,0
56,69,38,20,18,1345.2
56,70,15,10,5,540
56,71,210,107,103,7917
56,72,66,26,40,3504.6
56,73,20,12,8,1064
56,74,25,12,13,1135
56,75,112,56,56,4468.8
56,76,389,177,212,19099.9
56,77,196,107,89,8369.2
56,78,135,77,58,4968
56,79,65,35,30,2340
56,80,18,9,9,797.4
56,81,8,3,5,346.4
56,82,9,6,3,296.1
57,32,6,3,3,423
57,53,10,5,5,596
57,54,28,15,13,1142.4
57,63,10,4,6,477
57,64,17,9,8,629
57,65,12,5,7,597.6
57,73,7,4,3,310.8
57,74,6,3,3,327
57,77,13,6,7,443.3
57,78,19,11,8,457.9
57,79,85,47,38,3434
57,80,55,29,26,1831.5
57,81,11,6,5,441.1
58,2,2,1,1,0
58,31,2,1,1,0
58,53,1,1,0,0
58,54,24,11,13,919.2
58,63,40,20,20,1824
58,64,30,15,15,1452
58,80,2,1,1,0
59,54,27,15,12,1034.1
59,55,3,1,2,0
59,63,9,5,4,448.2
59,64,22,10,12,783.2
59,78,64,41,23,1907.2
59,89,3,2,1,0
60,30,1,1,0,0
60,49,2,1,1,0
60,50,1,1,0,0
60,54,49,26,23,2165.8
60,55,14,6,8,600.6
60,59,6,3,3,238.8
60,63,14,9,5,567
60,64,11,5,6,324.5
60,126,6,4,2,277.2
61,29,2,1,1,0
61,54,13,7,6,583.7
61,63,2,1,1,0
61,64,38,23,15,1428.8
61,65,9,6,3,324
61,66,1,1,0,0
61,126,4,2,2,0
62,29,6,3,3,304.2
62,30,5,4,1,282
62,52,2,1,1,0
62,53,86,42,44,3706.6
62,54,36,20,16,1479.6
62,55,10,5,5,429
62,63,18,11,7,626.4
62,64,595,285,310,25406.5
62,65,31,18,13,1429.1
62,66,19,10,9,763.8
62,67,6,3,3,238.8
62,126,10,5,5,289
62,127,2,1,1,0
63,26,5,3,2,208
63,28,10,6,4,558
63,29,20,12,8,894
63,30,3,2,1,0
63,53,32,17,15,1507.2
63,54,30,16,14,1275
63,55,145,76,69,5307
63,56,30,17,13,906
63,57,101,52,49,4141
63,58,11,6,5,553.3
63,59,18,9,9,867.6
63,60,24,13,11,818.4
63,61,4,3,1,0
63,64,131,69,62,5580.6
63,65,21,12,9,625.8
63,66,12,7,5,391.2
63,69,16,8,8,716.8
63,80,10,4,6,318
64,26,3,2,1,0
64,27,30,16,14,1488
64,28,42,21,21,1533
64,29,3,1,2,0
64,53,21,11,10,1005.9
64,54,67,39,28,2586.2
64,55,19,7,12,849.3
64,56,200,92,108,8880
64,57,610,289,321,30500
64,58,26,13,13,1019.2
64,59,13,6,7,478.4
64,60,28,15,13,1478.4
64,61,24,15,9,1140
64,62,13,7,6,413.4
64,63,6,3,3,150
64,64,48,27,21,1896
64,68,4,1,3,0
65,26,8,5,3,516
65,27,15,9,6,679.5
65,28,7,5,2,289.1
65,43,1,0,1,0
65,47,2,0,2,0
65,48,1,1,0,0
65,53,4,3,1,0
65,54,78,35,43,3003
65,55,34,13,21,1978.8
65,56,723,343,380,31739.7
65,57,213,107,106,9031.2
65,58,13,8,5,383.5
65,60,4,3,1,0
65,61,7,2,5,329.7
65,62,29,16,13,1310.8
65,63,26,15,11,1177.8
65,64,36,19,17,1468.8
65,70,1,1,0,0
65,72,1,1,0,0
65,73,5,3,2,271
65,123,3,1,2,0
66,24,5,4,1,303
66,25,8,4,4,340
66,28,6,2,4,235.2
66,45,9,4,5,444.6
66,46,4,3,1,0
66,47,17,10,7,729.3
66,52,14,7,7,653.8
66,53,50,29,21,2090
66,54,30,17,13,1323
66,55,170,78,92,7225
66,56,472,243,229,16756
66,57,16,9,7,734.4
66,62,1,1,0,0
66,124,2,1,1,0
67,4,9,6,3,334.8
67,25,7,4,3,406
67,45,5,3,2,281
67,47,1,1,0,0
67,51,2,1,1,0
67,52,10,6,4,402
67,53,75,45,30,3330
67,54,1,0,1,0
67,55,149,78,71,6421.9
67,56,45,27,18,1687.5
67,57,9,3,6,278.1
67,58,4,2,2,0
67,74,1,1,0,0
67,123,5,3,2,174
67,124,2,1,1,0
68,4,1,1,0,0
68,25,18,8,10,1092.6
68,26,9,4,5,304.2
68,51,17,10,7,615.4
68,52,36,25,11,1742.4
68,53,104,52,52,3900
68,55,26,13,13,977.6
68,56,43,16,27,1823.2
68,57,28,19,9,868
68,58,1,1,0,0
68,123,3,1,2,0
69,24,8,4,4,359.2
69,25,21,12,9,1066.8
69,26,4,2,2,0
69,52,57,29,28,2422.5
69,53,24,10,14,1101.6
69,54,14,7,7,593.6
69,55,11,7,4,422.4
69,56,3,1,2,0
69,57,3,1,2,0
69,121,2,1,1,0
69,122,5,3,2,130
70,23,1,1,0,0
70,24,32,20,12,1747.2
70,51,5,3,2,259
70,52,68,33,35,2652
70,53,47,25,22,1974
70,54,9,4,5,345.6
70,122,4,2,2,0
71,22,2,1,1,0
71,51,30,16,14,1206
71,52,41,22,19,1722
71,53,226,116,110,8927
71,54,92,48,44,3615.6
71,121,1,0,1,0
71,122,21,13,8,1110.9
71,123,4,3,1,0
72,21,5,4,1,168
72,22,9,5,4,446.4
72,51,53,26,27,1950.4
72,52,25,10,15,792.5
72,53,182,99,83,6115.2
72,121,2,1,1,0
72,122,8,6,2,390.4
72,123,6,3,3,231
72,124,10,6,4,542
73,21,7,4,3,382.9
73,22,1,1,0,0
73,35,4,2,2,0
73,50,11,7,4,314.6
73,51,10,4,6,416
73,52,14,10,4,590.8
73,53,54,29,25,2100.6
73,54,18,9,9,964.8
73,55,4,2,2,0
73,119,5,2,3,331
73,120,15,8,7,741
73,121,25,16,9,1180
73,122,10,6,4,462
74,21,51,23,28,2233.8
74,22,6,3,3,265.8
74,49,8,7,1,308.8
74,50,26,9,17,1003.6
74,51,41,26,15,1849.1
74,52,180,77,103,10440
74,53,38,22,16,1907.6
74,54,9,4,5,433.8
74,55,1,1,0,0
74,56,6,5,1,286.8
74,117,3,2,1,0
74,118,18,9,9,741.6
74,119,3,1,2,0
74,120,21,11,10,1113
74,121,6,3,3,169.8
74,122,15,10,5,550.5
74,123,1,1,0,0
75,20,2,1,1,0
75,21,13,6,7,621.4
75,23,1,1,0,0
75,46,5,1,4,154
75,47,10,6,4,467
75,48,26,14,12,1151.8
75,49,6,3,3,189
75,50,305,149,156,12779.5
75,51,238,111,127,10376.8
75,52,44,22,22,2204.4
75,53,37,21,16,1646.5
75,54,10,6,4,316
75,55,28,15,13,1052.8
75,56,8,5,3,311.2
75,117,6,4,2,256.8
75,118,3,2,1,0
75,119,14,7,7,474.6
75,120,29,16,13,1542.8
75,122,1,1,0,0
76,18,12,7,5,682.8
76,19,30,18,12,1482
76,20,17,8,9,768.4
76,40,2,1,1,0
76,45,2,1,1,0
76,46,1,1,0,0
76,47,40,21,19,1632
76,48,39,19,20,2180.1
76,49,32,14,18,1136
76,50,78,37,41,3439.8
76,51,48,19,29,2155.2
76,52,41,21,20,1668.7
76,53,3,2,1,0
76,117,19,12,7,843.6
76,118,10,6,4,488
76,119,14,9,5,376.6
76,120,1,1,0,0
77,17,2,1,1,0
77,18,6,2,4,195
77,19,20,10,10,924
77,41,1,1,0,0
77,46,2,1,1,0
77,47,18,10,8,739.8
77,48,130,62,68,6058
77,49,132,65,67,5359.2
77,50,39,18,21,1645.8
77,51,26,11,15,1417
77,52,9,5,4,162.9
77,116,6,5,1,123
78,10,1,1,0,0
78,14,8,5,3,410.4
78,15,15,8,7,781.5
78,16,8,6,2,460
78,17,6,4,2,289.2
78,47,26,11,15,985.4
78,48,58,30,28,2030
78,49,8,6,2,315.2
78,50,16,8,8,646.4
78,51,10,5,5,327
78,57,20,12,8,790
78,58,11,5,6,568.7
78,59,23,17,6,816.5
78,60,2,2,0,0
78,61,17,10,7,637.5
78,62,4,1,3,0
78,63,9,5,4,376.2
78,117,4,2,2,0
79,13,7,4,3,263.9
79,14,34,19,15,1567.4
79,15,61,32,29,2403.4
79,16,15,8,7,796.5
79,47,10,6,4,316
79,48,53,28,25,2088.2
79,50,6,4,2,246
79,51,13,6,7,491.4
79,56,22,10,12,789.8
79,57,7,4,3,287
79,115,19,13,6,872.1
79,116,11,4,7,485.1
80,10,8,4,4,306.4
80,12,2,2,0,0
80,13,14,7,7,306.6
80,14,13,7,6,366.6
80,16,8,3,5,399.2
80,23,1,0,1,0
80,26,4,3,1,0
80,48,5,4,1,302
80,49,36,20,16,1850.4
80,50,59,30,29,2377.7
80,51,7,5,2,301.7
80,53,3,2,1,0
80,54,2,1,1,0
80,55,11,4,7,458.7
80,56,6,4,2,357
80,59,2,1,1,0
80,67,2,1,1,0
80,108,17,8,9,732.7
80,111,2,1,1,0
80,115,4,2,2,0
80,116,28,16,12,1296.4
81,9,3,0,3,0
81,10,29,17,12,1560.2
81,11,20,9,11,568
81,12,27,14,13,1166.4
81,13,2,0,2,0
81,19,6,3,3,285
81,26,21,11,10,760.2
81,47,1,0,1,0
81,48,2,1,1,0
81,49,16,14,2,673.6
81,50,35,18,17,1617
81,51,5,3,2,123
81,52,17,9,8,664.7
81,53,8,5,3,254.4
81,54,33,17,16,1227.6
81,55,22,10,12,961.4
81,101,15,9,6,526.5
81,108,1,1,0,0
81,111,12,7,5,357.6
81,112,5,2,3,222
81,113,2,1,1,0
81,115,9,7,2,338.4
81,116,3,2,1,0
82,5,8,5,3,296.8
82,6,6,4,2,352.2
82,7,4,2,2,0
82,8,26,14,12,1471.6
82,9,23,13,10,924.6
82,10,156,74,82,8470.8
82,11,74,37,37,3700
82,12,10,4,6,472
82,17,1,1,0,0
82,18,35,20,15,1295
82,19,22,13,9,1113.2
82,20,17,8,9,486.2
82,25,4,0,4,0
82,47,2,1,1,0
82,49,54,30,24,2224.8
82,50,89,45,44,3328.6
82,51,7,5,2,350
82,52,10,3,7,406
82,53,4,1,3,0
82,56,6,3,3,252
82,95,3,1,2,0
82,101,1,0,1,0
82,105,5,3,2,238
82,112,1,1,0,0
82,113,4,1,3,0
82,115,214,107,107,9737
82,116,53,29,24,2210.1
83,3,5,2,3,248
83,4,13,7,6,527.8
83,5,23,10,13,1136.2
83,6,15,9,6,706.5
83,7,34,18,16,1509.6
83,8,19,9,10,769.5
83,9,42,20,22,2037
83,10,185,87,98,8436
83,11,312,148,164,13384.8
83,12,7,4,3,247.8
83,15,14,6,8,574
83,16,34,17,17,1360
83,17,24,12,12,957.6
83,18,31,15,16,1515.9
83,19,58,32,26,2151.8
83,20,34,16,18,1353.2
83,21,3,1,2,0
83,38,13,13,0,422.5
83,39,3,1,2,0
83,47,2,1,1,0
83,48,11,6,5,493.9
83,49,27,15,12,1333.8
83,50,26,16,10,1214.2
83,56,1,1,0,0
83,95,4,2,2,0
83,96,6,1,5,246
83,97,14,6,8,477.4
83,98,1,1,0,0
83,99,7,4,3,223.3
83,100,12,7,5,464.4
83,103,18,7,11,511.2
83,104,5,4,1,172
83,113,4,1,3,0
83,114,19,9,10,666.9
83,115,273,125,148,13377
83,116,12,8,4,624
84,2,2,1,1,0
84,3,17,8,9,802.4
84,4,25,11,14,860
84,5,3,1,2,0
84,6,2,1,1,0
84,7,9,5,4,350.1
84,9,6,3,3,238.8
84,10,39,20,19,1560
84,11,4,2,2,0
84,12,18,8,10,568.8
84,13,6,5,1,217.8
84,14,2,1,1,0
84,15,27,13,14,1560.6
84,16,40,18,22,1784
84,17,71,38,33,2328.8
84,18,60,32,28,2706
84,19,25,10,15,977.5
84,20,66,34,32,2857.8
84,21,5,2,3,189
84,37,12,6,6,633.6
84,38,6,2,4,244.2
84,41,7,4,3,364.7
84,46,9,4,5,232.2
84,48,185,94,91,8306.5
84,49,31,14,17,1271
84,50,5,3,2,262
84,57,2,1,1,0
84,58,2,1,1,0
84,60,8,2,6,352.8
84,61,7,3,4,340.2
84,63,15,5,10,535.5
84,91,4,3,1,0
84,107,1,1,0,0
84,113,4,3,1,0
84,114,36,17,19,1497.6
84,115,15,6,9,664.5
84,116,3,2,1,0
85,2,6,4,2,184.2
85,3,31,14,17,1295.8
85,10,5,3,2,252
85,11,2,1,1,0
85,12,6,5,1,273
85,13,20,10,10,680
85,14,29,14,15,1418.1
85,15,6,4,2,342
85,16,91,55,36,3303.3
85,17,23,13,10,920
85,18,33,18,15,1323.3
85,19,9,5,4,261.9
85,20,47,23,24,2397
85,21,15,7,8,655.5
85,22,24,12,12,864
85,23,8,5,3,202.4
85,36,8,3,5,380
85,37,11,5,6,331.1
85,40,11,6,5,447.7
85,42,19,9,10,701.1
85,43,1,1,0,0
85,44,12,8,4,736.8
85,45,17,6,11,513.4
85,46,17,6,11,623.9
85,47,553,265,288,24608.5
85,48,336,162,174,14985.6
85,49,5,2,3,159
85,60,2,1,1,0
85,113,17,9,8,688.5
85,114,84,43,41,3855.6
85,115,29,14,15,986
86,2,12,6,6,424.8
86,10,3,2,1,0
86,11,17,10,7,822.8
86,12,41,20,21,1517
86,13,84,42,42,3150
86,14,64,37,27,2553.6
86,15,52,27,25,2033.2
86,16,55,28,27,2123
86,17,49,24,25,2219.7
86,18,26,13,13,1146.6
86,20,44,28,16,1544.4
86,21,141,64,77,5724.6
86,22,21,11,10,873.6
86,23,12,7,5,622.8
86,35,3,3,0,0
86,36,13,9,4,617.5
86,37,26,14,12,1274
86,38,39,18,21,1177.8
86,39,18,7,11,538.2
86,40,20,11,9,960
86,41,31,16,15,1026.1
86,42,8,3,5,316.8
86,44,2,2,0,0
86,45,12,5,7,579.6
86,46,153,75,78,6762.6
86,47,147,74,73,6350.4
86,48,55,27,28,2310
86,49,70,33,37,3451
86,112,10,3,7,364
86,113,23,12,11,1283.4
86,114,22,12,10,770
87,1,7,5,2,272.3
87,2,23,14,9,1016.6
87,12,32,17,15,1318.4
87,13,384,188,196,16473.6
87,14,343,192,151,13377
87,15,40,20,20,1592
87,16,24,16,8,1039.2
87,17,7,4,3,441.7
87,20,2,1,1,0
87,21,18,8,10,925.2
87,22,17,9,8,797.3
87,23,1,1,0,0
87,28,1,1,0,0
87,33,8,4,4,332.8
87,34,2,1,1,0
87,35,26,14,12,1110.2
87,36,89,47,42,3275.2
87,37,58,33,25,2331.6
87,38,43,18,25,1646.9
87,39,233,121,112,9506.4
87,40,7,5,2,300.3
87,42,7,4,3,352.8
87,43,39,22,17,1458.6
87,44,17,8,9,843.2
87,45,29,16,13,1194.8
87,46,32,16,16,1305.6
87,47,8,3,5,387.2
87,50,2,1,1,0
87,88,1,1,0,0
87,113,20,10,10,872
87,114,2,1,1,0
88,1,22,15,7,952.6
88,2,16,11,5,516.8
88,11,12,4,8,543.6
88,12,43,23,20,1720
88,13,180,94,86,7884
88,14,10,6,4,370
88,21,5,1,4,167
88,30,10,5,5,269
88,31,4,3,1,0
88,32,16,9,7,771.2
88,34,5,2,3,208
88,35,1,0,1,0
88,36,132,62,70,4804.8
88,37,79,35,44,3262.7
88,38,268,124,144,14257.6
88,39,198,98,100,8632.8
88,40,9,5,4,504.9
88,41,11,5,6,464.2
88,42,20,9,11,702
88,43,29,13,16,1110.7
88,44,6,4,2,298.2
88,45,20,11,9,704
88,87,9,4,5,523.8
88,113,17,10,7,962.2
88,114,6,3,3,381
89,0,23,11,12,770.5
89,1,3,2,1,0
89,2,3,2,1,0
89,9,2,2,0,0
89,10,3,2,1,0
89,11,36,20,16,1378.8
89,12,16,6,10,572.8
89,13,41,20,21,1799.9
89,14,16,9,7,668.8
89,15,5,1,4,155
89,19,7,5,2,331.1
89,20,10,7,3,470
89,21,47,25,22,1955.2
89,22,9,6,3,272.7
89,29,11,7,4,523.6
89,30,28,16,12,1167.6
89,31,18,11,7,833.4
89,32,42,22,20,1957.2
89,33,43,20,23,1552.3
89,34,46,23,23,1656
89,35,68,32,36,2822
89,36,6,5,1,378
89,37,3,1,2,0
89,38,13,8,5,795.6
89,39,1,0,1,0
89,40,30,14,16,1380
89,42,4,2,2,0
89,113,4,3,1,0
90,0,30,17,13,1395
90,1,26,13,13,1084.2
90,8,23,13,10,1106.3
90,9,16,9,7,724.8
90,10,16,9,7,646.4
90,11,534,270,264,22534.8
90,12,301,140,161,13936.3
90,13,110,55,55,4279
90,14,36,22,14,1494
90,15,8,3,5,290.4
90,18,1,1,0,0
90,19,22,11,11,919.6
90,20,30,17,13,1173
90,21,63,33,30,2639.7
90,22,9,4,5,429.3
90,23,2,1,1,0
90,25,5,3,2,160
90,26,11,8,3,433.4
90,27,6,2,4,375
90,28,25,10,15,1040
90,29,13,8,5,721.5
90,31,52,27,25,2095.6
90,32,11,5,6,383.9
90,33,17,12,5,799
90,34,20,6,14,890
90,40,32,17,15,1452.8
90,114,3,3,0,0
90,115,5,2,3,229
90,116,1,1,0,0
91,0,100,53,47,3800
91,4,1,1,0,0
91,5,1,1,0,0
91,6,5,4,1,272
91,7,8,5,3,351.2
91,8,37,20,17,1857.4
91,9,27,15,12,923.4
91,10,62,35,27,2399.4
91,11,328,170,158,10856.8
91,12,36,19,17,1558.8
91,13,51,24,27,1881.9
91,14,10,4,6,569
91,18,6,4,2,216
91,19,15,8,7,478.5
91,20,7,5,2,387.1
91,21,39,18,21,1712.1
91,22,12,5,7,532.8
91,23,18,10,8,694.8
91,24,16,7,9,710.4
91,25,5,2,3,249
91,27,8,3,5,272.8
91,30,28,16,12,1232
91,31,28,18,10,1181.6
91,32,9,4,5,474.3
91,33,5,3,2,304
91,40,19,12,7,1008.9
91,78,10,5,5,462
91,85,3,1,2,0
91,115,12,5,7,573.6
91,116,20,10,10,724
91,117,10,5,5,298
92,0,32,14,18,1193.6
92,4,19,8,11,902.5
92,5,17,6,11,622.2
92,6,11,6,5,500.5
92,7,29,14,15,1078.8
92,8,68,35,33,2502.4
92,9,77,40,37,2933.7
92,10,33,19,14,1359.6
92,11,63,23,40,2305.8
92,12,26,13,13,826.8
92,13,12,7,5,542.4
92,18,13,6,7,587.6
92,19,10,4,6,480
92,20,8,5,3,288
92,21,28,16,12,1167.6
92,22,375,180,195,15862.5
92,23,435,224,211,18705
92,24,35,22,13,1347.5
92,25,51,27,24,2136.9
92,26,52,25,27,2402.4
92,27,17,6,11,693.6
92,28,16,7,9,692.8
92,29,4,2,2,0
92,31,6,2,4,190.8
92,32,7,4,3,364
92,39,20,9,11,770
92,40,7,5,2,298.9
92,50,10,6,4,377
92,75,3,2,1,0
92,76,1,1,0,0
92,77,2,1,1,0
92,83,12,6,6,522
92,84,5,3,2,177
92,116,49,21,28,2028.6
92,117,25,15,10,870
93,4,30,15,15,1092
93,5,13,8,5,681.2
93,6,71,38,33,3138.2
93,7,5,1,4,114
93,8,72,33,39,2988
93,9,48,25,23,2131.2
93,10,48,25,23,1804.8
93,11,3,2,1,0
93,18,8,3,5,208
93,20,5,3,2,260
93,21,55,31,24,2337.5
93,22,63,37,26,3263.4
93,23,43,21,22,1492.1
93,24,41,20,21,1783.5
93,25,11,5,6,480.7
93,26,11,6,5,501.6
93,27,15,8,7,622.5
93,28,21,15,6,892.5
93,29,7,4,3,268.8
93,32,3,2,1,0
93,39,12,7,5,406.8
93,80,1,1,0,0
93,81,1,0,1,0
93,82,21,13,8,974.4
93,116,2,1,1,0
93,117,10,6,4,471
93,118,14,9,5,431.2
94,1,3,2,1,0
94,3,47,25,22,1489.9
94,4,145,74,71,6003
94,5,21,10,11,867.3
94,6,26,17,9,1014
94,8,9,4,5,385.2
94,17,18,12,6,586.8
94,19,16,11,5,873.6
94,22,5,2,3,258
94,23,19,5,14,813.2
94,24,9,6,3,491.4
94,38,4,3,1,0
94,39,35,18,17,1354.5
94,116,1,1,0,0
94,117,6,3,3,301.2
94,118,9,4,5,365.4
95,0,4,2,2,0
95,1,15,9,6,643.5
95,2,19,12,7,826.5
95,3,220,118,102,6996
95,4,294,147,147,11083.8
95,5,46,25,21,2125.2
95,6,40,21,19,1908
95,7,7,4,3,408.1
95,18,27,16,11,1250.1
95,19,41,21,20,1619.5
95,38,28,13,15,1142.4
95,48,1,0,1,0
95,71,2,2,0,0
95,119,9,5,4,287.1
96,0,17,8,9,800.7
96,1,43,24,19,1711.4
96,2,5,2,3,139
96,3,10,5,5,332
96,4,108,62,46,4762.8
96,5,232,125,107,8120
96,6,249,120,129,9586.5
96,7,47,27,20,2110.3
96,8,5,3,2,223
96,9,2,1,1,0
96,16,23,9,14,966
96,17,48,26,22,1924.8
96,18,59,35,24,2301
96,19,47,23,24,1964.6
96,38,5,2,3,145
96,39,8,6,2,271.2
96,118,7,5,2,280
96,119,18,9,9,738
97,0,72,39,33,2822.4
97,1,36,22,14,1656
97,2,20,9,11,700
97,3,48,25,23,1752
97,4,114,56,58,4411.8
97,5,68,40,28,2828.8
97,6,299,156,143,11541.4
97,7,35,16,19,1263.5
97,8,33,19,14,1534.5
97,9,44,24,20,1834.8
97,10,13,6,7,513.5
97,15,9,5,4,381.6
97,16,47,24,23,1865.9
97,17,25,12,13,780
97,18,46,22,24,2125.2
97,19,28,17,11,1243.2
97,20,6,3,3,271.2
97,41,6,3,3,234
97,82,2,2,0,0
97,83,1,1,0,0
97,119,4,2,2,0
97,120,1,1,0,0
97,121,1,1,0,0
98,0,334,160,174,13660.6
98,1,844,409,435,35110.4
98,2,616,266,350,30492
98,3,80,40,40,3728
98,9,28,15,13,1212.4
98,10,32,21,11,1628.8
98,11,19,9,10,741
98,12,16,12,4,577.6
98,13,26,13,13,969.8
98,14,129,67,62,4089.3
98,15,35,16,19,1039.5
98,16,139,67,72,5573.9
98,17,239,114,125,10539.9
98,18,75,35,40,2910
98,19,24,13,11,1005.6
98,72,2,1,1,0
98,82,1,0,1,0
98,119,4,3,1,0
98,120,16,6,10,558.4
99,0,2400,1103,1297,107520
99,1,2053,937,1116,94643.3
99,2,1841,886,955,72535.4
99,3,173,94,79,6816.2
99,4,2,1,1,0
99,10,3,2,1,0
99,11,20,8,12,620
99,12,30,16,14,900
99,13,167,87,80,6162.3
99,14,970,489,481,38509
99,15,253,127,126,11233.2
99,16,79,40,39,3578.7
99,17,41,22,19,1619.5
99,18,7,4,3,361.9
99,19,5,3,2,163
99,72,2,2,0,0
99,73,16,8,8,635.2
99,82,2,1,1,0
99,121,3,2,1,0
100,0,949,443,506,39858
100,1,749,364,385,32581.5
100,2,659,322,337,27546.2
100,3,139,76,63,5963.1
100,4,8,4,4,275.2
100,10,54,27,27,2332.8
100,11,76,38,38,3245.2
100,12,83,40,43,3278.5
100,13,31,19,12,1255.5
100,14,87,40,47,3166.8
100,15,84,44,40,3637.2
100,16,28,12,16,1027.6
100,73,11,5,6,588.5
100,81,1,1,0,0
100,121,3,2,1,0
101,0,28,14,14,1024.8
101,1,19,9,10,809.4
101,2,109,55,54,3618.8
101,3,45,22,23,2133
101,14,13,7,6,481
101,15,12,6,6,452.4
101,74,4,3,1,0
101,120,7,2,5,315
102,2,32,17,15,1299.2
102,3,15,7,8,892.5
102,11,2,0,2,0
102,16,1,1,0,0
102,74,3,2,1,0
102,120,2,1,1,0
102,121,1,1,0,0
103,2,22,10,12,970.2
103,3,7,4,3,277.9
103,11,2,2,0,0
103,12,3,2,1,0
103,16,3,2,1,0
103,74,1,1,0,0
103,75,2,1,1,0
103,120,2,1,1,0
103,125,8,4,4,280.8
104,2,12,8,4,514.8
104,3,2,0,2,0
104,121,4,2,2,0
104,125,8,6,2,494.4
104,126,5,4,1,128
105,74,6,3,3,217.2
106,74,22,12,10,1086.8
106,75,2,1,1,0
106,119,20,7,13,492
106,120,7,4,3,258.3
106,122,1,1,0,0
107,74,5,2,3,295
107,75,5,3,2,283
107,108,1,1,0,0
107,119,2,1,1,0
107,120,1,0,1,0
108,1,2,1,1,0
108,5,1,1,0,0
108,6,22,7,15,882.2
108,7,2,2,0,0
108,74,5,2,3,207
108,119,6,3,3,307.8
109,0,34,20,14,1720.4
109,1,5,2,3,117
109,65,1,1,0,0
109,74,4,3,1,0
109,109,1,1,0,0
109,118,4,2,2,0
110,0,48,22,26,2030.4
110,54,1,1,0,0
110,109,13,8,5,482.3
111,3,18,10,8,658.8
111,53,3,1,2,0
111,109,16,8,8,569.6
111,110,19,11,8,541.5
111,111,52,28,24,2168.4
111,112,22,12,10,963.6
111,113,3,1,2,0
111,116,4,1,3,0
111,123,1,1,0,0
112,1,7,3,4,228.9
112,2,3,2,1,0
112,3,39,19,20,1489.8
112,65,3,1,2,0
112,75,9,3,6,351
112,108,2,1,1,0
112,110,22,11,11,1111
112,111,92,48,44,3762.8
112,112,89,52,37,3471
112,113,5,4,1,118
112,114,23,10,13,908.5
112,115,5,3,2,302
112,116,18,8,10,828
113,65,2,1,1,0
113,75,3,1,2,0
113,108,1,0,1,0
113,110,16,9,7,1000
113,111,21,13,8,892.5
113,112,140,68,72,4914
113,113,38,18,20,1474.4
113,114,7,1,6,147
114,14,45,28,17,1570.5
114,74,5,1,4,85
114,108,2,0,2,0
114,109,15,8,7,529.5
114,110,105,51,54,3612
114,111,21,12,9,1073.1
114,112,95,50,45,3315.5
114,113,3,1,2,0
114,120,1,1,0,0
115,74,5,2,3,173
115,107,33,16,17,1277.1
115,108,34,19,15,1509.6
115,109,6,2,4,264
115,110,71,38,33,2925.2
115,111,25,15,10,1265
115,112,38,16,22,1858.2
115,113,5,4,1,226
115,114,18,11,7,831.6
115,116,16,9,7,435.2
115,117,9,4,5,340.2
115,118,5,3,2,199
115,120,9,3,6,182.7
115,121,10,6,4,305
115,122,1,0,1,0
116,72,6,3,3,217.2
116,106,65,36,29,2249
116,108,12,7,5,560.4
116,109,212,98,114,8564.8
116,110,337,153,184,14760.6
116,111,42,19,23,1789.2
116,112,30,14,16,1137
116,113,6,2,4,253.8
116,114,11,5,6,333.3
116,115,3,1,2,0
116,116,7,3,4,389.2
116,117,13,6,7,604.5
116,118,6,4,2,172.2
116,119,31,15,16,1382.6
116,120,58,28,30,2418.6
116,122,5,1,4,138
117,107,9,5,4,377.1
117,108,66,31,35,2818.2
117,109,19,11,8,872.1
117,112,5,2,3,237
117,119,14,8,6,739.2
117,120,15,8,7,672
117,121,9,6,3,322.2
117,122,15,6,9,709.5
117,123,18,10,8,662.4
117,124,10,5,5,486
117,127,18,11,7,723.6
118,70,2,1,1,0
118,106,14,7,7,512.4
118,107,39,21,18,1794
118,108,9,5,4,324.9
118,113,1,1,0,0
118,120,6,3,3,208.8
118,121,14,6,8,551.6
118,122,57,24,33,1892.4
118,123,3,2,1,0
118,125,8,4,4,248.8
118,126,72,33,39,2563.2
118,127,98,55,43,3724
119,68,2,1,1,0
119,69,1,1,0,0
119,104,5,3,2,265
119,105,15,6,9,589.5
119,106,17,9,8,610.3
119,112,3,2,1,0
119,123,5,3,2,177
119,124,1,1,0,0
119,125,11,6,5,415.8
119,126,62,29,33,2101.8
119,127,24,10,14,1082.4
120,68,6,3,3,244.8
120,102,2,2,0,0
120,103,16,8,8,556.8
120,126,8,3,5,384
120,127,25,11,14,945
121,1,1,1,0,0
121,67,1,0,1,0
121,68,4,2,2,0
121,101,6,2,4,271.2
121,102,1,1,0,0
121,126,2,0,2,0
121,127,29,13,16,1160
122,100,11,5,6,533.5
122,101,10,7,3,506
122,122,1,0,1,0
122,125,24,12,12,1053.6
122,126,49,27,22,2121.7
122,127,62,33,29,2232
123,53,1,1,0,0
123,66,16,11,5,728
123,67,73,45,28,3569.7
123,100,46,26,20,1794
123,126,9,3,6,270.9
123,127,149,72,77,5408.7
124,51,1,1,0,0
124,65,13,7,6,650
124,66,15,10,5,598.5
124,67,15,4,11,646.5
124,99,10,4,6,363
124,100,6,2,4,228
124,109,8,5,3,343.2
124,110,16,7,9,816
124,111,37,18,19,1232.1
124,112,55,28,27,2431
124,113,15,10,5,586.5
124,114,5,3,2,220
124,120,8,4,4,352
124,126,579,274,305,22581
124,127,274,122,152,12932.8
125,54,3,1,2,0
125,57,9,6,3,546.3
125,65,4,2,2,0
125,66,2,1,1,0
125,75,2,1,1,0
125,77,4,2,2,0
125,98,5,3,2,90
125,99,7,2,5,244.3
125,107,4,2,2,0
125,108,27,14,13,785.7
125,109,69,34,35,2829
125,110,25,12,13,1270
125,111,36,19,17,1461.6
125,112,34,18,16,1417.8
125,113,5,1,4,275
125,126,256,137,119,8294.4
125,127,794,378,416,33586.2
126,53,1,1,0,0
126,54,11,6,5,414.7
126,55,11,9,2,383.9
126,56,12,7,5,361.2
126,58,7,3,4,349.3
126,59,3,3,0,0
126,60,4,3,1,0
126,63,3,1,2,0
126,78,4,2,2,0
126,97,1,1,0,0
126,105,8,4,4,184.8
126,106,2,1,1,0
126,107,13,8,5,516.1
126,108,16,9,7,750.4
126,109,14,7,7,614.6
126,127,25,14,11,737.5
127,53,3,1,2,0
127,54,2,1,1,0
127,59,3,2,1,0
127,78,5,2,3,133
127,79,10,5,5,448
127,96,2,0,2,0
127,105,7,3,4,328.3
127,106,4,2,2,0