x,y,p,m,f,ta
84,61,1,1,0,0
90,66,12,5,7,426
90,67,18,10,8,1042.2
91,66,31,17,14,1168.7
91,67,52,29,23,2116.4
92,67,172,87,85,7894.8
92,68,43,19,24,1595.3
93,67,49,25,24,2557.8
93,68,154,76,78,6221.6
93,69,16,10,6,796.8
94,68,1,1,0,0
94,69,2,2,0,0
116,84,2,1,1,0
117,82,36,16,20,1602
117,83,107,54,53,4376.3
117,84,41,25,16,1644.1
117,86,1,1,0,0
118,81,14,6,8,565.6
118,82,132,68,64,5728.8
118,83,245,124,121,10069.5
118,84,1,1,0,0
118,86,24,12,12,1065.6
119,82,140,71,69,5502
119,86,13,6,7,692.9