x,y,p,m,f,ta
0,67,6,4,2,367.8
0,74,25,11,14,932.5
0,93,3,2,1,0
0,95,51,28,23,1943.1
1,26,40,16,24,1436
1,28,20,9,11,612
1,29,12,4,8,528
1,30,102,47,55,3927
1,31,412,211,201,15244
1,32,417,212,205,17972.7
1,33,283,147,136,10725.7
1,34,167,92,75,6897.1
1,35,292,159,133,10979.2
1,36,319,162,157,13142.8
1,67,17,9,8,749.7
1,74,338,159,179,15210
1,93,14,6,8,610.4
1,94,3,1,2,0
1,95,141,73,68,4892.7
1,96,319,160,159,14546.4
2,17,62,34,28,2808.6
2,18,12,6,6,616.8
2,19,13,6,7,434.2
2,20,4,2,2,0
2,21,3,2,1,0
2,22,5,3,2,212
2,23,5,2,3,257
2,24,47,22,25,1743.7
2,25,10,6,4,500
2,26,8,4,4,252.8
2,31,725,320,405,35960
2,32,1257,582,675,56942.1
2,33,1047,519,528,47533.8
2,34,34,14,20,1513
2,40,4,2,2,0
2,74,112,57,55,5297.6
2,93,33,16,17,1244.1
2,94,17,10,7,799
2,95,3,2,1,0
2,96,800,384,416,35120
3,17,244,117,127,9198.8
3,18,45,22,23,1881
3,19,35,17,18,1564.5
3,20,9,5,4,471.6
3,21,4,2,2,0
3,33,11,6,5,504.9
3,38,410,216,194,16605
3,41,1,1,0,0
3,42,13,6,7,729.3
3,43,20,11,9,844
3,44,10,6,4,299
3,74,14,8,6,533.4
3,91,10,6,4,309
3,92,16,9,7,585.6
3,93,28,14,14,1204
3,94,306,158,148,12025.8
3,95,298,124,174,16300.6
3,96,1440,666,774,64224
3,97,23,10,13,1345.5
3,98,3,2,1,0
3,99,102,46,56,4426.8
4,13,2,1,1,0
4,14,6,3,3,424.8
4,15,6,3,3,220.8
4,20,11,6,5,423.5
4,38,282,150,132,11167.2
4,40,8,5,3,318.4
4,41,5,3,2,285
4,45,18,11,7,685.8
4,46,2,0,2,0
4,47,23,10,13,759
4,68,26,14,12,1294.8
4,69,24,10,14,868.8
4,70,3,1,2,0
4,74,8,6,2,344.8
4,75,4,2,2,0
4,83,12,5,7,363.6
4,86,6,3,3,184.8
4,87,1,1,0,0
4,88,13,8,5,621.4
4,89,28,12,16,1008
4,90,17,9,8,555.9
4,91,25,11,14,1187.5
4,92,80,41,39,3024
4,93,19,11,8,606.1
4,94,117,51,66,5031
4,95,855,426,429,33601.5
4,96,1135,507,628,53004.5
4,97,174,82,92,7499.4
4,98,411,196,215,18536.1
4,99,778,392,386,28552.6
4,100,55,36,19,2095.5
4,109,4,2,2,0
5,12,3,2,1,0
5,13,1,0,1,0
5,14,14,8,6,488.6
5,42,1,1,0,0
5,43,5,2,3,339
5,47,14,7,7,782.6
5,48,27,12,15,1571.4
5,49,10,6,4,410
5,52,45,27,18,1827
5,53,64,28,36,2521.6
5,70,9,6,3,500.4
5,71,7,6,1,356.3
5,83,2,2,0,0
5,86,20,9,11,910
5,87,1,0,1,0
5,88,6,4,2,334.8
5,89,4,2,2,0
5,90,7,3,4,151.2
5,91,121,61,60,4053.5
5,95,41,20,21,1886
5,96,273,139,134,11001.9
5,97,24,13,11,688.8
5,98,141,68,73,5527.2
5,99,98,55,43,3616.2
5,100,93,48,45,3589.8
5,101,7,3,4,272.3
5,112,2,1,1,0
6,45,19,10,9,811.3
6,46,10,7,3,417
6,47,3,1,2,0
6,52,6,3,3,325.8
6,53,56,28,28,2710.4
6,54,54,29,25,2791.8
6,55,42,26,16,1936.2
6,71,21,9,12,1010.1
6,72,9,4,5,374.4
6,95,36,23,13,1641.6
6,96,283,139,144,10301.2
6,97,28,13,15,1232
6,99,25,14,11,1362.5
6,101,51,27,24,2381.7
6,102,27,14,13,1155.6
6,111,17,6,11,831.3
6,112,9,6,3,441.9
7,39,8,3,5,351.2
7,47,33,19,14,1402.5
7,48,39,19,20,1723.8
7,49,15,8,7,595.5
7,55,1,1,0,0
7,56,19,11,8,596.6
7,57,1,1,0,0
7,72,14,8,6,824.6
7,73,6,4,2,360
7,76,6,3,3,382.8
7,93,9,5,4,345.6
7,94,30,15,15,1206
7,95,76,38,38,2629.6
7,96,12,5,7,416.4
7,97,131,65,66,5279.3
7,98,8,5,3,216.8
7,99,3,2,1,0
7,100,19,12,7,951.9
7,101,27,15,12,1090.8
7,102,11,7,4,632.5
7,103,9,5,4,396
7,104,1,1,0,0
7,106,5,4,1,296
7,110,10,6,4,475
7,111,14,8,6,448
7,114,5,3,2,164
7,117,4,1,3,0
7,118,19,11,8,929.1
8,50,82,43,39,2927.4
8,51,68,32,36,2414
8,52,5,3,2,166
8,53,19,7,12,623.2
8,56,10,4,6,420
8,57,162,89,73,6172.2
8,58,42,22,20,1898.4
8,73,20,11,9,1008
8,93,20,10,10,752
8,94,29,14,15,1113.6
8,95,7,4,3,370.3
8,96,1,1,0,0
8,97,76,38,38,2994.4
8,98,12,6,6,466.8
8,99,14,6,8,411.6
8,100,67,39,28,2599.6
8,101,35,15,20,1515.5
8,102,28,14,14,991.2
8,103,10,4,6,374
8,104,21,11,10,795.9
8,105,19,11,8,893
8,106,9,6,3,506.7
8,110,29,13,16,1122.3
8,111,52,22,30,2059.2
8,112,58,27,31,2227.2
8,116,23,13,10,961.4
8,117,6,2,4,415.8
8,118,67,33,34,2673.3
8,119,24,12,12,1173.6
9,51,9,4,5,424.8
9,52,30,17,13,1224
9,53,82,40,42,3427.6
9,54,42,21,21,1755.6
9,55,50,28,22,2315
9,56,4,2,2,0
9,58,6,2,4,367.8
9,59,1,1,0,0
9,61,9,3,6,405.9
9,62,3,1,2,0
9,72,4,2,2,0
9,75,6,5,1,105
9,92,135,69,66,5008.5
9,93,460,242,218,13570
9,94,195,102,93,6610.5
9,95,122,64,58,4989.8
9,96,25,11,14,1197.5
9,97,56,25,31,2144.8
9,98,10,6,4,470
9,99,99,49,50,3702.6
9,100,125,57,68,4725
9,104,4,2,2,0
9,105,15,8,7,580.5
9,106,7,5,2,370.3
9,108,2,1,1,0
9,109,9,5,4,441
9,110,30,14,16,1290
9,111,11,4,7,540.1
9,112,100,48,52,3670
9,113,18,9,9,462.6
9,115,6,3,3,187.8
9,116,2,1,1,0
9,119,39,23,16,1805.7
9,120,10,5,5,430
10,0,2,1,1,0
10,3,11,5,6,419.1
10,21,1,1,0,0
10,62,26,14,12,1237.6
10,63,47,22,25,1936.4
10,64,29,13,16,1621.1
10,72,2,1,1,0
10,91,21,14,7,1024.8
10,92,84,33,51,2797.2
10,93,125,63,62,4475
10,94,28,15,13,1232
10,97,1,1,0,0
10,98,11,6,5,425.7
10,99,35,20,15,1312.5
10,112,5,3,2,211
10,113,127,72,55,4165.6
10,120,9,3,6,493.2
10,121,2,0,2,0
11,3,37,15,22,1587.3
11,20,1,1,0,0
11,58,33,16,17,1049.4
11,59,100,51,49,3720
11,60,76,33,43,3245.2
11,61,4,3,1,0
11,64,6,2,4,106.8
11,65,44,23,21,1887.6
11,66,49,29,20,2018.8
11,67,3,3,0,0
11,71,46,19,27,1950.4
11,72,90,31,59,4743
11,77,21,10,11,1148.7
11,91,6,4,2,225
11,92,25,10,15,1065
11,93,10,5,5,235
11,97,1,1,0,0
11,113,55,33,22,1875.5
11,120,11,6,5,503.8
11,121,2,1,1,0
11,122,1,1,0,0
12,2,12,3,9,394.8
12,4,5,3,2,89
12,60,274,149,125,11124.4
12,61,136,68,68,5358.4
12,62,63,29,34,2709
12,63,7,4,3,245.7
12,64,3,1,2,0
12,66,26,13,13,1058.2
12,67,40,20,20,2032
12,68,17,7,10,515.1
12,69,1,0,1,0
12,70,4,1,3,0
12,71,7,4,3,224.7
12,74,8,3,5,383.2
12,88,2,1,1,0
12,91,10,5,5,496
12,92,40,20,20,1584
12,99,3,2,1,0
12,100,11,6,5,621.5
12,113,5,4,1,94
13,2,15,7,8,385.5
13,3,8,3,5,336.8
13,4,49,26,23,1955.1
13,5,15,7,8,472.5
13,64,45,27,18,2011.5
13,65,16,8,8,870.4
13,68,1,1,0,0
13,69,19,10,9,1107.7
13,74,4,2,2,0
13,78,24,12,12,1104
13,79,33,16,17,1379.4
13,80,12,8,4,358.8
13,100,47,27,20,1748.4
13,102,4,2,2,0
13,111,13,7,6,505.7
13,112,108,48,60,5302.8
13,113,54,28,26,2192.4
14,4,53,24,29,2660.6
14,5,253,122,131,11891
14,65,30,14,16,1212
14,66,83,43,40,3643.7
14,67,25,14,11,827.5
14,77,8,4,4,403.2
14,78,7,4,3,359.1
14,79,3,2,1,0
14,90,13,8,5,461.5
14,99,5,4,1,242
14,100,35,17,18,1379
14,111,3,2,1,0
14,112,5,4,1,333
14,113,47,25,22,2152.6
15,5,21,9,12,921.9
15,66,4,3,1,0
15,72,5,3,2,208
15,79,1,0,1,0
15,89,8,4,4,387.2
15,90,7,4,3,336.7
15,91,1,1,0,0
15,100,37,22,15,1520.7
15,101,2,1,1,0
15,112,17,10,7,725.9
15,113,21,9,12,907.2
16,5,7,5,2,142.8
16,64,4,3,1,0
16,65,500,234,266,20700
16,66,5,3,2,174
16,83,2,1,1,0
16,87,3,2,1,0
16,88,18,11,7,847.8
16,89,29,16,13,1206.4
16,90,4,3,1,0
16,100,2,1,1,0
16,112,17,8,9,572.9
16,113,11,7,4,534.6
16,114,6,2,4,115.2
17,7,3,2,1,0
17,64,2,1,1,0
17,65,29,15,14,1093.3
17,69,9,7,2,261
17,70,1,0,1,0
17,81,2,1,1,0
17,82,10,4,6,531
17,83,6,4,2,333
17,84,8,4,4,454.4
17,85,2,1,1,0
17,86,9,6,3,410.4
17,87,39,20,19,1365
17,88,20,10,10,944
17,90,5,3,2,168
17,100,1,0,1,0
17,113,5,3,2,297
17,114,8,6,2,419.2
18,71,25,14,11,797.5
18,75,2,1,1,0
18,81,31,14,17,1193.5
18,82,321,151,170,13963.5
18,83,7,4,3,230.3
18,84,14,8,6,516.6
18,86,23,12,11,1115.5
18,99,14,10,4,613.2
18,100,7,4,3,305.9
18,113,38,19,19,1432.6
18,114,25,12,13,1065
19,62,3,2,1,0
19,74,2,1,1,0
19,75,36,19,17,1314
19,76,4,2,2,0
19,82,32,16,16,1324.8
19,83,37,21,16,1661.3
19,84,15,8,7,634.5
19,85,19,10,9,951.9
19,86,69,39,30,2718.6
19,87,4,2,2,0
19,99,1,0,1,0
19,113,5,3,2,189
19,114,55,29,26,2002
20,72,29,14,15,1032.4
20,76,14,9,5,495.6
20,83,5,3,2,76
20,85,7,4,3,198.8
20,112,24,11,13,916.8
20,114,9,6,3,537.3
20,115,5,2,3,282
20,116,8,4,4,312.8
20,117,9,5,4,368.1
21,73,29,13,16,1380.4
21,84,3,0,3,0
21,99,18,8,10,934.2
21,100,1,0,1,0
21,115,8,5,3,508
21,117,12,8,4,506.4
22,78,12,5,7,402
22,88,1,1,0,0
22,98,2,1,1,0
22,99,2,1,1,0
23,75,9,4,5,393.3
23,77,2,1,1,0
23,89,6,3,3,208.8
23,98,5,3,2,240
23,121,20,10,10,762
23,122,4,2,2,0
23,124,4,3,1,0
24,75,15,8,7,625.5
24,77,7,5,2,370.3
24,89,1,1,0,0
24,124,11,6,5,397.1
25,75,35,22,13,1557.5
25,77,6,3,3,424.2
25,119,4,1,3,0
26,77,2,1,1,0
26,118,6,3,3,244.8
27,75,5,3,2,289
27,85,2,1,1,0
27,87,5,3,2,194
27,100,4,3,1,0
27,118,24,11,13,705.6
28,82,6,3,3,268.2
28,83,8,4,4,388
28,84,3,2,1,0
28,85,50,28,22,2025
28,86,14,7,7,806.4
28,87,9,5,4,431.1
28,119,2,1,1,0
29,83,6,3,3,220.8
29,84,31,16,15,1171.8
29,85,159,80,79,7711.5
29,86,227,116,111,9443.2
29,120,31,16,15,1494.2
30,83,18,10,8,732.6
30,84,11,8,3,386.1
30,85,131,66,65,5004.2
30,86,145,79,66,6815
30,87,15,9,6,618
30,120,1,1,0,0
30,121,2,2,0,0
31,84,3,2,1,0
31,85,55,28,27,2370.5
31,86,80,39,41,3448
31,87,8,4,4,464
31,124,7,6,1,396.9
31,125,4,2,2,0
32,75,7,5,2,366.8
32,84,9,6,3,353.7
32,85,35,20,15,1603
32,100,1,1,0,0
34,1,7,5,2,165.9
35,127,2,1,1,0
36,72,81,36,45,2851.2
36,73,284,129,155,11672.4
36,86,1,1,0,0
36,87,40,19,21,1692
36,88,2,1,1,0
37,69,1,0,1,0
37,70,4,2,2,0
37,72,48,23,25,2102.4
37,73,102,50,52,4345.2
37,74,122,63,59,4282.2
38,67,37,18,19,1779.7
38,68,27,11,16,1204.2
38,71,1,1,0,0
38,75,3,1,2,0
39,67,52,24,28,2288
39,68,66,36,30,2824.8
40,77,1,0,1,0
41,76,5,2,3,257
42,109,3,0,3,0
43,103,7,2,5,238.7
43,109,5,3,2,182
43,111,3,2,1,0
43,113,2,1,1,0
43,116,19,8,11,701.1
43,127,3,1,2,0
44,76,9,7,2,502.2
44,111,11,4,7,526.9
44,112,4,1,3,0
44,114,55,28,27,2546.5
44,115,30,16,14,1254
44,116,148,75,73,5994
44,117,50,26,24,2345
44,126,15,8,7,766.5
44,127,44,24,20,1909.6
45,67,3,1,2,0
45,114,26,12,14,821.6
45,117,18,8,10,523.8
45,126,2,1,1,0
45,127,17,7,10,802.4
46,67,8,5,3,360
46,118,28,13,15,1352.4
46,119,2,1,1,0
47,65,7,4,3,156.8
47,66,15,8,7,646.5
47,67,9,5,4,453.6
47,68,7,4,3,231
47,118,6,4,2,252
47,120,38,21,17,1770.8
47,121,7,4,3,436.8
48,66,2,1,1,0
48,121,136,63,73,6052
49,120,10,6,4,418
49,121,269,124,145,10141.3
49,122,214,111,103,8688.4
49,123,176,90,86,7304
49,124,2,1,1,0
49,126,22,11,11,862.4
50,65,4,2,2,0
50,93,1,1,0,0
50,119,8,4,4,284.8
50,120,30,15,15,1461
50,123,8,5,3,468
51,118,27,11,16,1171.8
51,119,36,19,17,1882.8
51,121,1,1,0,0
51,122,7,4,3,193.9
52,117,30,14,16,1437
52,118,11,6,5,477.4
55,117,16,9,7,782.4
56,117,63,40,23,2910.6
57,119,4,1,3,0
61,86,4,3,1,0
62,85,2,0,2,0
62,86,2,2,0,0
64,110,1,1,0,0
70,3,1,0,1,0
75,19,3,1,2,0
75,66,1,0,1,0
76,18,2,1,1,0
77,18,1,1,0,0
80,3,4,2,2,0
80,15,2,1,1,0
80,73,7,5,2,273.7
81,12,2,1,1,0
82,95,2,1,1,0
83,7,2,1,1,0
85,0,2,0,2,0
85,1,1,1,0,0
85,8,3,1,2,0
87,1,1,0,1,0
89,0,2,1,1,0
89,1,3,2,1,0
89,71,6,3,3,193.8
89,89,1,0,1,0
89,90,3,1,2,0
90,70,2,2,0,0
90,71,18,11,7,871.2
90,88,13,8,5,434.2
90,89,9,5,4,420.3
91,70,4,2,2,0
91,71,1,0,1,0
91,88,25,10,15,1200
92,86,4,2,2,0
92,87,1,0,1,0
92,88,8,6,2,312
93,84,3,1,2,0
94,73,12,6,6,450
95,73,13,7,6,574.6
95,84,18,11,7,730.8
95,85,2,1,1,0
96,73,30,17,13,1593
96,74,18,8,10,804.6
96,84,34,17,17,1635.4
96,85,6,4,2,166.8
97,73,153,82,71,6548.4
97,74,25,15,10,1360
97,84,140,71,69,5782
97,85,7,5,2,408.8
98,67,5,3,2,236
98,73,220,104,116,9482
98,74,27,14,13,1293.3
98,84,107,57,50,4932.7
99,66,6,3,3,252
99,67,2,1,1,0
99,70,1,0,1,0
99,72,11,5,6,468.6
99,73,180,82,98,8874
99,74,139,67,72,7102.9
99,75,24,12,12,993.6
99,76,2,1,1,0
99,83,7,2,5,196.7
99,84,49,25,24,2116.8
100,71,1,1,0,0
100,72,26,11,15,1021.8
100,73,516,258,258,18421.2
100,74,396,209,187,16750.8
100,75,126,68,58,5355
100,83,25,13,12,1255
100,84,33,18,15,1372.8
101,68,3,2,1,0
101,69,6,4,2,190.2
101,70,2,1,1,0
101,73,30,15,15,1053
101,74,399,195,204,16279.2
101,75,182,89,93,7443.8
101,76,11,5,6,475.2
101,83,39,21,18,1723.8
102,67,2,1,1,0
102,68,44,20,24,1953.6
102,75,57,36,21,2502.3
102,76,27,13,14,961.2
102,83,2,1,1,0
103,67,14,5,9,624.4
103,68,21,13,8,903
103,76,25,13,12,737.5
103,82,5,3,2,160
103,83,3,1,2,0
103,118,4,3,1,0
104,48,3,1,2,0
104,66,15,8,7,480
104,67,21,9,12,991.2
104,76,18,11,7,797.4
104,77,22,11,11,1067
104,82,47,23,24,1804.8
104,83,24,12,12,799.2
104,93,10,4,6,312
105,66,15,7,8,754.5
105,76,1,0,1,0
105,77,29,15,14,1336.9
105,78,17,11,6,453.9
105,79,6,3,3,379.8
105,81,4,1,3,0
105,82,255,123,132,11934
105,83,22,12,10,1073.6
105,89,8,6,2,364
105,90,6,4,2,300
106,65,4,4,0,0
106,78,18,9,9,651.6
106,79,15,7,8,757.5
106,81,66,34,32,2376
106,82,68,32,36,2828.8
106,89,13,6,7,609.7
106,90,21,11,10,856.8
107,64,13,9,4,530.4
107,65,9,5,4,473.4
107,78,5,2,3,325
107,79,40,21,19,1648
107,80,18,7,11,912.6
107,81,34,15,19,1400.8
107,90,11,7,4,447.7
108,58,1,0,1,0
108,64,4,3,1,0
108,78,15,9,6,630
108,79,3,2,1,0
108,80,36,23,13,1533.6
108,81,8,5,3,280.8
108,90,6,5,1,256.2
108,91,10,5,5,542
109,58,6,4,2,343.2
109,59,2,1,1,0
109,65,5,2,3,258
109,78,8,4,4,408
109,79,21,8,13,779.1
109,90,30,13,17,936
109,91,5,4,1,171
110,27,7,2,5,333.9
110,58,13,5,8,383.5
110,59,10,7,3,451
110,77,6,4,2,241.8
110,78,13,6,7,534.3
110,90,22,12,10,807.4
110,91,35,15,20,1498
111,0,1,1,0,0
111,59,74,38,36,3130.2
111,77,12,6,6,585.6
111,78,16,9,7,534.4
111,90,4,3,1,0
111,91,25,13,12,1175
112,48,10,6,4,416
112,59,18,10,8,918
112,66,2,1,1,0
112,78,15,10,5,486
112,90,7,3,4,399.7
113,48,32,15,17,1251.2
113,49,7,4,3,179.9
113,54,3,1,2,0
113,59,12,5,7,552
113,78,14,8,6,575.4
113,79,18,9,9,817.2
113,84,2,1,1,0
113,85,12,6,6,540
113,90,9,5,4,453.6
113,107,2,1,1,0
113,110,21,13,8,567
114,47,11,7,4,558.8
114,48,3,2,1,0
114,49,1,0,1,0
114,57,1,1,0,0
114,59,5,5,0,223
114,60,9,6,3,253.8
114,79,29,13,16,1612.4
114,84,15,8,7,592.5
114,91,21,13,8,924
114,110,23,12,11,890.1
114,117,4,3,1,0
115,34,1,0,1,0
115,45,8,5,3,318.4
115,46,45,28,17,1723.5
115,47,14,8,6,442.4
115,60,2,1,1,0
115,67,2,1,1,0
115,79,6,3,3,405
115,80,16,10,6,692.8
115,84,18,9,9,684
115,91,26,16,10,1118
115,92,12,6,6,417.6
115,110,13,10,3,488.8
115,116,6,3,3,234
115,117,13,7,6,486.2
116,43,1,0,1,0
116,45,31,14,17,1404.3
116,58,4,2,2,0
116,67,2,1,1,0
116,80,15,8,7,736.5
116,81,6,4,2,283.2
116,83,10,6,4,490
116,84,7,5,2,174.3
116,90,30,15,15,933
116,91,108,51,57,4082.4
116,92,15,6,9,324
116,110,19,9,10,676.4
116,114,2,1,1,0
116,115,1,0,1,0
116,116,18,9,9,862.2
117,13,1,0,1,0
117,14,3,2,1,0
117,40,9,3,6,341.1
117,41,4,3,1,0
117,43,10,7,3,394
117,44,5,4,1,257
117,67,4,3,1,0
117,81,236,104,132,8212.8
117,82,174,82,92,5898.6
117,83,2,0,2,0
117,89,7,3,4,315.7
117,90,24,12,12,1140
117,91,47,23,24,1706.1
117,107,1,0,1,0
117,110,28,14,14,957.6
117,111,24,12,12,876
117,112,1,0,1,0
118,12,4,3,1,0
118,13,20,12,8,742
118,41,12,5,7,538.8
118,42,13,6,7,425.1
118,81,290,146,144,11310
118,82,279,135,144,11801.7
118,83,70,37,33,2632
118,87,27,16,11,891
118,88,28,13,15,980
118,89,48,23,25,1454.4
118,90,9,4,5,423
118,107,1,0,1,0
118,108,1,1,0,0
118,110,186,83,103,6417
118,111,62,35,27,2287.8
119,0,49,28,21,2058
119,9,11,5,6,216.7
119,12,22,11,11,1240.8
119,27,8,4,4,339.2
119,41,21,11,10,831.6
119,81,31,13,18,961
119,82,420,212,208,18354
119,83,77,40,37,2979.9
119,84,7,3,4,329.7
119,86,10,7,3,407
119,87,55,26,29,2178
119,88,20,9,11,948
119,89,6,3,3,180
119,90,1,0,1,0
119,109,9,3,6,495
119,110,33,19,14,1587.3
119,111,11,7,4,432.3
120,0,18,13,5,700.2
120,1,44,21,23,1716
120,2,1,0,1,0
120,10,1,1,0,0
120,11,23,10,13,1051.1
120,12,6,3,3,297
120,20,3,2,1,0
120,26,12,6,6,763.2
120,27,2,1,1,0
120,41,16,7,9,782.4
120,81,18,10,8,869.4
120,82,397,174,223,19294.2
120,83,416,196,220,18304
120,84,3,1,2,0
120,85,9,7,2,414
120,86,34,16,18,1445
120,87,3,3,0,0
120,90,2,1,1,0
120,108,12,8,4,411.6
120,109,16,9,7,977.6
120,110,20,11,9,694
121,1,8,5,3,355.2
121,2,16,8,8,790.4
121,3,4,3,1,0
121,9,6,4,2,180
121,10,26,14,12,806
121,11,23,8,15,924.6
121,25,12,7,5,511.2
121,26,34,16,18,1380.4
121,41,5,3,2,137
121,81,3,2,1,0
121,82,4,3,1,0
121,83,80,33,47,3760
121,84,10,5,5,565
121,85,61,32,29,2342.4
121,108,23,12,11,752.1
121,109,248,120,128,8308
122,3,141,66,75,6330.9
122,4,18,10,8,811.8
122,9,2,0,2,0
122,10,136,69,67,6460
122,11,23,11,12,867.1
122,17,1,0,1,0
122,18,1,1,0,0
122,19,8,4,4,428.8
122,20,3,1,2,0
122,25,5,3,2,356
122,26,13,7,6,613.6
122,41,6,2,4,256.8
122,84,91,54,37,3549
122,85,75,42,33,2730
122,96,4,1,3,0
122,107,14,9,5,551.6
122,108,311,142,169,12906.5
122,109,149,82,67,5885.5
123,3,211,100,111,9199.6
123,4,11,3,8,541.2
123,9,8,3,5,523.2
123,10,34,18,16,1326
123,11,32,14,18,1248
123,12,36,19,17,1519.2
123,13,24,13,11,1020
123,14,10,6,4,313
123,15,7,4,3,305.2
123,16,20,10,10,790
123,17,8,5,3,339.2
123,18,16,10,6,636.8
123,25,8,3,5,480
123,41,9,6,3,360
123,83,11,6,5,418
123,84,7,3,4,247.1
123,85,65,32,33,2216.5
123,86,20,11,9,762
123,106,30,14,16,1071
123,107,9,4,5,404.1
123,108,53,31,22,2088.2
124,3,23,11,12,1311
124,9,25,13,12,720
124,10,44,26,18,1650
124,11,10,6,4,391
124,16,7,2,5,228.9
124,23,6,3,3,223.2
124,24,4,2,2,0
124,41,6,4,2,397.8
124,84,7,5,2,343.7
124,85,55,28,27,2370.5
124,86,11,5,6,434.5
124,105,46,25,21,2019.4
124,107,16,9,7,686.4
124,108,16,7,9,745.6
125,3,103,51,52,4027.3
125,4,1,1,0,0
125,8,9,2,7,398.7
125,10,2,2,0,0
125,18,2,1,1,0
125,19,18,6,12,896.4
125,20,2,1,1,0
125,22,7,5,2,205.1
125,41,11,7,4,694.1
125,42,9,5,4,388.8
125,62,17,8,9,637.5
125,83,3,1,2,0
125,84,34,18,16,1380.4
125,85,5,4,1,296
125,86,8,2,6,311.2
125,103,1,0,1,0
125,104,6,4,2,213
125,105,105,51,54,4042.5
125,106,86,48,38,3259.4
125,107,33,17,16,1415.7
126,3,20,10,10,1094
126,4,5,3,2,161
126,5,2,1,1,0
126,7,4,2,2,0
126,8,2,1,1,0
126,18,32,17,15,1097.6
126,19,4,3,1,0
126,41,21,11,10,903
126,42,18,10,8,788.4
126,62,1,1,0,0
126,84,19,11,8,1014.6
126,86,55,29,26,2480.5
126,87,24,11,13,835.2
126,102,2,1,1,0
126,104,6,3,3,307.8
126,105,233,117,116,6943.4
126,106,46,17,29,1725
127,4,8,3,5,428
127,5,1,1,0,0
127,6,12,6,6,526.8
127,7,4,2,2,0
127,10,126,47,79,7534.8
127,11,125,64,61,5425
127,14,3,1,2,0
127,15,16,7,9,470.4
127,16,26,10,16,743.6
127,17,12,5,7,402
127,18,33,19,14,1597.2
127,40,3,2,1,0
127,41,64,34,30,2739.2
127,42,29,17,12,1229.6
127,60,1,1,0,0
127,63,8,5,3,254.4
127,84,23,12,11,869.4
127,85,11,7,4,324.5
127,86,70,33,37,2842
127,87,10,5,5,414
127,102,13,9,4,557.7
127,103,3,0,3,0
127,104,4,1,3,0
127,105,38,21,17,1827.8