x,y,p,m,f,ta
12,108,158,87,71,6114.8
12,109,32,16,16,1721.6
13,108,21,13,8,709.8
19,115,94,46,48,3445.6
20,98,48,29,19,1977.6
20,99,111,58,53,4288.2
20,100,374,193,181,15045.8
20,101,266,137,129,11236.7
20,102,510,256,254,20305.2
20,103,575,302,273,21798.300000000003
20,104,712,371,341,26694.4
20,105,1023,479,544,38285.7
20,111,17,10,7,686.8
21,98,1433,706,727,59256
21,99,363,199,164,13972.900000000001
21,103,200,112,88,7927.8
21,104,2683,1308,1375,98240.6
21,105,3207,1609,1598,116091.2
21,106,568,297,271,20890.800000000003
21,107,343,176,167,12937.6
21,108,191,101,90,6106.3
21,109,33,18,15,1189
21,111,25,13,12,962.5
21,112,7,4,3,256.2
22,98,1423,710,713,55587.6
22,99,229,120,109,8592.7
22,100,5,2,3,0
22,105,307,153,154,10084.3
22,106,1921,968,953,70894.8
22,107,462,243,219,16490
22,108,131,74,57,4814.8
22,109,10,5,5,520
22,110,213,103,110,7758.8
22,111,20,11,9,967.4
22,112,16,9,7,813.2
22,123,101,51,50,4912.1
23,98,6,4,2,196.2
23,99,21,13,8,1036.6
23,100,47,24,23,1765.6000000000001
23,101,8,3,5,396
23,105,769,396,373,24196.5
23,106,643,326,317,24041.8
23,107,18,9,9,808.5
23,108,12,5,7,328
23,109,289,155,134,11742.2
23,110,558,299,259,20363.1
23,111,355,177,178,13386.699999999999
23,112,759,382,377,28195.6
23,113,199,104,95,7156.8
23,114,227,111,116,7105.1
23,123,165,91,74,6151.5
23,125,27,15,12,1413.3
23,126,8,5,3,592
23,127,22,8,14,1103
24,101,12,8,4,401.4
24,102,10,5,5,171
24,103,159,89,70,5882.1
24,104,508,257,251,19900.2
24,105,4018,2007,2011,155125.7
24,106,2298,1159,1139,89202.4
24,107,514,270,244,17484.3
24,108,615,309,306,25590.600000000002
24,109,1487,742,745,55402.3
24,110,760,378,382,33527
24,111,964,493,471,39403.4
24,112,4236,2196,2040,171365.2
24,113,9330,4948,4382,368566.5
24,114,5533,2716,2817,207129
24,115,147,76,71,5098.8
24,116,98,50,48,3649.7
24,117,94,48,46,3488.2999999999997
24,118,4,2,2,0
24,119,5,3,2,140
24,123,603,308,295,22412
24,124,256,113,143,11932.000000000002
24,125,5,3,2,323
24,126,7,4,3,230.3
25,76,6,4,2,178.2
25,92,3,2,1,0
25,93,441,230,211,18613.5
25,99,19,9,10,624.2
25,100,1,1,0,0
25,105,2,1,1,0
25,106,17,11,6,561.6
25,107,9,5,4,584.1
25,108,50,26,24,1862
25,109,1562,772,790,51939.7
25,110,1831,917,914,67598.2
25,111,4146,2041,2105,168505.8
25,112,6353,3114,3239,241761.6
25,113,4045,1957,2088,155808.9
25,114,2597,1310,1287,96869.99999999999
25,115,74,41,33,2571.4
25,116,256,133,123,8966.1
25,117,219,114,105,7718.8
25,118,31,16,15,1436.8000000000002
25,119,98,63,35,3990.8
25,120,67,36,31,2528.2
25,121,5,4,1,161
25,124,4,2,2,0
25,125,31,20,11,1014
26,69,2,1,1,0
26,70,43,22,21,1563.1
26,71,303,215,88,10188.1
26,72,77,44,33,3236.1
26,73,145,74,71,5981.5
26,74,97,52,45,3468.2000000000003
26,75,7,4,3,0
26,76,67,36,31,2691.6
26,93,83,44,39,3176.3
26,99,11,4,7,460
26,100,31,17,14,952.2
26,101,20,13,7,682
26,105,28,11,17,1149.2
26,106,34,14,20,1306.8
26,107,117,59,58,4754.2
26,108,257,138,119,10562.6
26,109,105,52,53,4317.299999999999
26,110,164,90,74,6474.2
26,111,637,324,313,20867.4
26,112,1385,685,700,39081.2
26,113,97,46,51,2836.5
26,115,4,2,2,0
26,116,60,33,27,2289
26,117,365,188,177,9724.900000000001
26,118,86,45,41,2903.2
26,121,71,35,36,3010.1
26,122,35,17,18,954.1
27,67,25,10,15,669.6
27,68,21,12,9,791.4000000000001
27,69,92,48,44,3695.3
27,70,197,110,87,7018.5
27,71,404,216,188,13798.3
27,72,165,96,69,5950.8
27,73,745,407,338,25877.4
27,74,155,88,67,5704.299999999999
27,75,81,43,38,2956.1000000000004
27,76,47,24,23,1759.1
27,77,55,29,26,1679.5
27,78,76,40,36,2846.3
27,79,26,15,11,1042.7
27,84,6,3,3,0
27,99,20,10,10,1011.6
27,100,24,11,13,1113.9
27,101,45,24,21,1610.6
27,102,239,106,133,10053.8
27,105,15,8,7,373.5
27,106,69,34,35,2694.2000000000003
27,107,14,8,6,392.7
27,109,31,16,15,1271.6
27,110,246,126,120,8261
27,111,754,379,375,24741.399999999998
27,112,1080,562,518,36227.7
27,113,1263,635,628,47071.1
27,114,73,39,34,2376.6
27,115,4,3,1,0
27,117,16,8,8,502.6
27,118,50,25,25,1730.8
27,119,391,203,188,13160.3
27,120,510,250,260,22211
27,121,57,31,26,1884.9
27,122,20,9,11,1095.5
27,123,109,54,55,3903.7
27,124,20,12,8,894
28,64,43,27,16,1416
28,65,51,27,24,1776.6
28,66,72,40,32,2400.2
28,67,1648,848,800,54797
28,68,144,70,74,5193.3
28,69,54,24,30,1858.1000000000001
28,70,1034,517,517,41222.9
28,71,104,51,53,3842.7
28,72,215,114,101,8304.3
28,73,203,113,90,7547.9
28,74,232,126,106,8643.1
28,75,145,75,70,5574.1
28,76,153,85,68,5897.5
28,77,549,290,259,19994.6
28,78,163,78,85,7177.6
28,79,321,163,158,12144.099999999999
28,80,1010,518,492,29225.2
28,81,431,214,217,13132
28,82,4,3,1,0
28,100,2,1,1,0
28,101,322,178,144,12115
28,102,65,37,28,2357.5
28,103,18,10,8,609.4
28,105,41,24,17,1477.7
28,106,95,49,46,3665.4
28,107,119,60,59,3607.6
28,108,51,28,23,2178.3
28,110,40,20,20,1420
28,111,55,34,21,2259.8
28,112,1274,653,621,38760.2
28,113,1076,536,540,35567.6
28,114,84,47,37,3327.8
28,115,5,3,2,132
28,116,1,1,0,0
28,117,28,13,15,1054.4
28,119,23,16,7,750.2
28,120,645,324,321,19352.7
28,121,5,2,3,294
28,122,39,23,16,1225.8
28,123,4,2,2,0
28,124,76,39,37,2622.9
29,63,56,32,24,2125.8999999999996
29,64,1808,927,881,63666.8
29,65,199,94,105,7242.6
29,66,109,56,53,4301.900000000001
29,67,1715,876,839,63193.3
29,68,124,71,53,4140.900000000001
29,69,2547,1285,1262,72854.5
29,70,3428,1723,1705,128019.2
29,71,113,57,56,4504.9
29,72,288,161,127,8309.2
29,73,2083,1046,1037,80897.7
29,74,4705,2395,2310,170536.30000000002
29,75,191,102,89,7382.599999999999
29,76,5604,2836,2768,201919.1
29,77,2337,1172,1165,77383.5
29,78,291,167,124,9958.6
29,79,128,58,70,4735
29,80,1281,643,638,42354.1
29,81,325,170,155,12164.7
29,82,108,60,48,4316.8
29,83,317,153,164,10926.4
29,84,109,63,46,3658.5
29,85,4551,2305,2246,170997.4
29,86,511,252,259,17206.2
29,88,140,71,69,5518.799999999999
29,89,125,60,65,4957.1
29,101,37,23,14,1606.1
29,103,8,5,3,266.4
29,104,9,5,4,394.2
29,105,225,118,107,8422
29,106,282,154,128,8352.5
29,107,107,59,48,3720.3
29,108,76,40,36,2721.8
29,109,50,24,26,2009
29,110,188,102,86,6260.700000000001
29,111,33,11,22,1334.1
29,112,154,76,78,6279.8
29,113,547,269,278,28626.1
29,116,6,1,5,144
29,117,5,3,2,211
29,118,7,5,2,247.1
29,119,87,46,41,3079.8999999999996
29,120,158,80,78,6001.700000000001
29,121,87,50,37,3445.4
29,122,13,4,9,377
29,123,9,3,6,253.8
29,124,31,16,15,1512.8
29,125,246,132,114,10046.7
30,63,283,151,132,9538.4
30,64,571,320,251,18908.3
30,65,92,48,44,3907.2999999999997
30,66,58,28,30,2208.8
30,67,34,16,18,879.3
30,68,95,50,45,2832
30,69,53,27,26,1574.5
30,70,89,45,44,3001.9
30,71,71,40,31,2787
30,72,147,79,68,4942.2
30,73,3216,1644,1572,103673.79999999999
30,74,1555,754,801,60361.8
30,75,372,192,180,11731.7
30,76,1120,573,547,38574.1
30,77,168,92,76,6169.400000000001
30,78,171,90,81,5976.400000000001
30,79,254,143,111,8776.5
30,80,179,105,74,6712.9
30,81,133,75,58,5694.099999999999
30,82,295,139,156,10682.400000000001
30,83,256,136,120,8373.6
30,84,1105,571,534,38123.100000000006
30,85,484,253,231,17808.2
30,86,3026,1527,1499,114165.6
30,87,4974,2503,2471,179703.3
30,88,2107,1055,1052,75628.1
30,89,834,452,382,30144.3
30,90,186,92,94,7426.5
30,94,45,27,18,1762.3999999999999
30,95,2,1,1,0
30,104,8,6,2,340.8
30,105,64,25,39,2569.6
30,106,34,15,19,940.2
30,107,78,41,37,3199.6
30,108,42,24,18,1829.4
30,109,3,2,1,0
30,110,115,61,54,4319.5
30,111,216,108,108,6843.8
30,112,540,284,256,13263.9
30,113,404,202,202,14414.8
30,114,41,14,27,1564
30,115,68,35,33,2877.9
30,116,10,6,4,475.3
30,117,26,14,12,884
30,118,88,43,45,3653
30,119,99,48,51,3257.9
30,120,26,12,14,967.7
30,121,37,16,21,1423.2
30,122,25,14,11,1157.7
30,123,33,18,15,978
30,124,100,52,48,3534.4
30,125,11,7,4,359.8
31,62,45,26,19,1773.8999999999999
31,63,270,139,131,10190.6
31,64,299,160,139,7803.900000000001
31,65,6,3,3,0
31,66,32,18,14,1103.2
31,67,74,35,39,2886.5
31,68,48,22,26,1565.6
31,69,30,14,16,1154.4
31,70,68,38,30,2652.7999999999997
31,71,91,47,44,3698.6
31,72,116,57,59,4519.4
31,73,167,74,93,6913
31,74,111,51,60,4452.7
31,75,71,36,35,2118.6
31,76,1308,656,652,42298
31,77,249,143,106,9110.5
31,78,361,184,177,13541.8
31,79,360,186,174,13782.5
31,80,136,74,62,5493
31,81,191,103,88,7134.8
31,82,7787,3911,3876,274409.4
31,83,2949,1504,1445,107060.29999999999
31,84,28,15,13,966
31,85,2633,1366,1267,99243.4
31,86,3825,1908,1917,131465.4
31,87,735,395,340,25128.9
31,88,2254,1096,1158,85217.79999999999
31,89,1776,899,877,62718.2
31,90,10,5,5,548
31,94,250,133,117,9192.7
31,95,279,146,133,8396.3
31,96,89,43,46,3638.9
31,104,16,8,8,544.7
31,105,4,2,2,0
31,106,13,8,5,469.7
31,107,29,13,16,1117.9
31,108,30,15,15,1002.5
31,109,19,9,10,540.8
31,110,16,8,8,915.2
31,111,97,51,46,3955.9
31,112,21,12,9,787.3
31,113,23,11,12,870.2
31,114,16,9,7,432
31,115,37,18,19,1406
31,116,13,7,6,474.5
31,117,22,12,10,520
31,118,8,4,4,280
31,119,16,8,8,695.3
31,120,1,1,0,0
31,122,50,23,27,1934.7
31,123,462,237,225,16523.199999999997
31,124,17,9,8,697
31,125,82,44,38,3339.2999999999997
31,126,119,64,55,4441.5
31,127,3,1,2,0
32,59,14,6,8,449.4
32,60,612,323,289,24093.4
32,61,376,182,194,13640.6
32,62,25,11,14,942.2
32,63,60,26,34,2348.2
32,64,56,30,26,1693.9
32,65,9,4,5,315
32,67,1,1,0,0
32,68,8,5,3,0
32,69,14,6,8,651.2
32,70,311,177,134,10982.9
32,71,137,72,65,5001.2
32,72,103,55,48,3796
32,73,1663,873,790,57033.899999999994
32,74,557,292,265,15780.5
32,75,1122,562,560,36065.3
32,76,3598,1867,1731,121300
32,77,512,274,238,16301
32,78,4996,2534,2462,165856.7
32,79,6695,3325,3370,244072.5
32,80,6659,3344,3315,230660.8
32,81,1993,1016,977,63408
32,82,400,195,205,13260.4
32,83,1625,871,754,57337.200000000004
32,84,1340,709,631,46181.5
32,85,9249,4472,4777,360288.6
32,86,5920,2873,3047,239491.4
32,87,2760,1341,1419,98419.9
32,88,5681,2859,2822,198101.90000000002
32,89,1159,608,551,41667
32,90,240,128,112,8359.199999999999
32,91,230,114,116,7688.200000000001
32,92,20,11,9,864
32,93,140,79,61,5851.099999999999
32,94,41,19,22,1815.5
32,95,105,55,50,4035
32,96,3,1,2,0
32,106,55,27,28,2136
32,107,49,25,24,1585.6
32,108,5,2,3,0
32,110,8,4,4,0
32,112,6,3,3,0
32,113,162,84,78,6285.4
32,114,9,5,4,251
32,115,79,38,41,2907.2000000000003
32,116,77,44,33,2820.9
32,117,64,34,30,2415.3
32,118,12,7,5,367.2
32,120,19,12,7,754
32,121,12,5,7,553.3
32,122,19,12,7,710.6
32,123,40,25,15,1366.8
32,124,3,2,1,0
32,125,5,4,1,0
32,126,47,28,19,2200.9
32,127,94,51,43,4161.3
33,59,56,28,28,2049.7
33,60,5,2,3,135
33,61,62,30,32,1934.9
33,63,23,13,10,1113.2
33,64,9,3,6,156.8
33,65,34,19,15,1148.3
33,68,30,17,13,1220.2
33,69,27,15,12,982.5
33,70,170,84,86,5993.1
33,71,132,68,64,5216
33,72,19,9,10,953.1
33,73,6,3,3,108
33,74,16,8,8,568
33,75,28,15,13,866.3
33,76,31,17,14,1340.3
33,77,33,17,16,1006.5
33,78,5778,2950,2828,157640.5
33,79,4847,2476,2371,175694.5
33,80,10675,5443,5232,436539.69999999995
33,81,7561,3883,3678,272667.9
33,82,6096,3102,2994,210664.40000000002
33,83,7328,3704,3624,253557.9
33,84,7868,3895,3973,292643.1
33,85,9538,4643,4895,350412.1
33,86,12418,6334,6084,474913.60000000003
33,87,10124,5194,4930,381168
33,88,2987,1474,1513,111382.9
33,90,141,82,59,4860.8
33,91,409,206,203,12300.099999999999
33,92,371,192,179,13397.9
33,93,94,49,45,2737
33,94,149,71,78,7974.8
33,95,24,10,14,1076
33,106,11,6,5,647.9
33,107,27,11,16,835.3
33,108,36,18,18,1242.5
33,109,40,18,22,1577.6
33,110,3,1,2,0
33,111,9,5,4,247.1
33,112,38,16,22,1458.1
33,113,6,2,4,0
33,114,72,42,30,2361.6
33,115,13,7,6,698.2
33,116,257,127,130,9759.4
33,117,194,103,91,6860.3
33,118,52,31,21,2007.8
33,119,50,23,27,2289.1
33,121,25,16,9,1044.1
33,122,3,2,1,0
33,123,7,5,2,261.8
33,124,3,1,2,0
33,125,1,1,0,0
33,126,1,1,0,0
34,56,71,39,32,2669.6
34,57,58,27,31,2350.5
34,58,141,75,66,4347
34,59,613,312,301,23448.6
34,65,19,7,12,583.0999999999999
34,66,26,11,15,762
34,67,23,13,10,797.2
34,68,2,2,0,0
34,69,19,10,9,642.9
34,70,28,16,12,1041.5
34,72,27,11,16,1127.1
34,73,63,31,32,2814
34,74,41,21,20,1288.7
34,75,23,14,9,924.2
34,76,458,224,234,16450.5
34,77,213,94,119,8111.8
34,78,69,38,31,2371.8
34,79,1978,990,988,70169.5
34,80,3377,1667,1710,127538.50000000001
34,81,1556,776,780,58574.100000000006
34,82,106,56,50,2499.4
34,83,3,1,2,0
34,84,2823,1377,1446,122227.20000000001
34,85,4948,2396,2552,192482.70000000004
34,86,17062,9045,8017,600509.2
34,87,3128,1674,1454,112679.4
34,88,7597,3802,3795,271929.2
34,89,9,4,5,450
34,90,7,4,3,343.7
34,91,9,6,3,411.3
34,92,59,27,32,2059.1
34,93,105,54,51,3816
34,94,887,447,440,27841.2
34,95,142,71,71,4943.6
34,103,15,6,9,638.3
34,104,8,6,2,439.2
34,105,42,22,20,1582
34,106,3,1,2,0
34,108,13,6,7,718.9
34,109,3,2,1,0
34,110,15,8,7,730.6
34,111,34,20,14,1097.5
34,112,431,232,199,14934.3
34,113,62,32,30,1966.3
34,114,4,2,2,0
34,116,95,51,44,3658.2
34,117,400,207,193,13315.800000000001
34,119,8,4,4,428.8
34,120,2,1,1,0
34,121,124,59,65,4606.5
34,122,190,92,98,7277.3
34,123,16,7,9,742.5
34,124,13,8,5,425
34,125,6,4,2,229
34,127,4,1,3,0
35,56,62,31,31,2306.4
35,57,156,85,71,6770.7
35,58,42,21,21,1381.7
35,59,62,31,31,3054.6000000000004
35,60,34,16,18,1101.4
35,62,3,2,1,0
35,65,3,0,3,0
35,66,7,3,4,270
35,68,6,3,3,408
35,69,6,3,3,228
35,70,9,5,4,173
35,73,11,6,5,305.8
35,74,762,401,361,26079.5
35,75,5175,2604,2571,167585.8
35,76,1021,559,462,34300.7
35,77,43,21,22,1495.9
35,78,408,208,200,14812.1
35,79,131,73,58,4564.2
35,80,670,348,322,23983.4
35,81,37,18,19,1375.4
35,82,3,1,2,0
35,83,4,2,2,0
35,84,24,14,10,1171.2
35,86,198,99,99,6516
35,87,937,475,462,32812.2
35,88,868,434,434,31997.6
35,90,274,143,131,9754.7
35,92,31,17,14,1128.4
35,93,296,149,147,10206.900000000001
35,94,1,1,0,0
35,95,15,5,10,658
35,105,44,22,22,1496.6
35,106,14,6,8,266.4
35,107,44,25,19,1240
35,108,14,5,9,612.4
35,109,1,1,0,0
35,110,49,26,23,1735
35,111,43,23,20,1544.6
35,112,19,12,7,673.0999999999999
35,115,18,12,6,751.2
35,116,39,18,21,1744.4
35,117,83,44,39,2667.5
35,118,8,4,4,270.4
35,121,35,18,17,1200.5
35,122,26,14,12,1332.5
35,123,25,15,10,892.5
35,124,7,3,4,0
35,125,26,15,11,865
35,126,39,22,17,1652.9
36,55,10,5,5,326.9
36,56,64,32,32,3385.2
36,57,398,212,186,12251
36,58,93,49,44,3938.1
36,60,37,22,15,1447.4
36,63,20,12,8,620
36,68,11,6,5,212
36,70,6,3,3,226.8
36,71,16,7,9,504.4
36,72,2,1,1,0
36,74,87,46,41,3281.2999999999997
36,75,3335,1684,1651,109671.70000000001
36,76,18,8,10,802.8
36,77,13,9,4,440.7
36,78,35,20,15,1162.1
36,79,85,44,41,3633.7
36,80,44,20,24,1631.6999999999998
36,81,38,26,12,1714.8000000000002
36,82,156,80,76,6075.7
36,83,2387,1245,1142,77490.2
36,84,669,335,334,21421.7
36,86,1,1,0,0
36,87,25,11,14,1170.7
36,92,42,20,22,1617
36,93,435,225,210,13500
36,94,95,48,47,3331.1
36,96,45,21,24,1336.5
36,105,3,2,1,0
36,106,18,10,8,657.4
36,107,26,14,12,1082.2
36,110,2,1,1,0
36,111,2,1,1,0
36,114,7,4,3,277.2
36,115,33,19,14,1131
36,116,2,2,0,0
36,117,18,8,10,540
36,118,10,6,4,368.8
36,119,1,0,1,0
36,123,12,6,6,278.3
36,124,17,7,10,620.7
36,125,108,56,52,5000.4
36,126,50,25,25,2254.8
37,54,2,1,1,0
37,55,624,328,296,21302.5
37,56,3954,1981,1973,149394.7
37,57,2040,1051,989,76607
37,58,137,78,59,5476.3
37,60,35,18,17,1304.8
37,68,9,5,4,183
37,70,4,1,3,0
37,73,20,13,7,564
37,74,36,18,18,1556.6000000000001
37,75,47,24,23,2056.2
37,76,11,7,4,308
37,77,31,16,15,1348.5
37,78,35,19,16,1323
37,79,98,56,42,3409.6000000000004
37,80,15,9,6,594
37,81,37,21,16,1248.2
37,82,6,3,3,133.8
37,83,2583,1323,1260,85079
37,84,912,456,456,38010.3
37,85,53,25,28,2105.6
37,86,5,4,1,0
37,90,2,1,1,0
37,91,1,1,0,0
37,92,11,5,6,277.2
37,94,94,50,44,2709
37,96,79,44,35,3191.1000000000004
37,97,182,94,88,7010
37,98,24,13,11,935.4
37,107,22,13,9,762.4
37,108,9,5,4,410.4
37,113,44,23,21,1876.4
37,114,55,28,27,2365.9
37,115,192,87,105,8435.8
37,116,22,11,11,1288
37,117,108,54,54,3901.3
37,118,179,91,88,6499.4
37,119,107,60,47,3870.6
37,120,23,9,14,802.7
37,122,3,2,1,0
37,123,11,5,6,488
37,124,9,7,2,291.6
37,125,198,99,99,7988.3
38,52,5,4,1,178
38,53,93,45,48,3842.1000000000004
38,54,114,51,63,4401.3
38,55,76,45,31,3192.3
38,56,514,244,270,22732.1
38,57,3341,1620,1721,137508.9
38,58,735,389,346,19795.5
38,59,35,14,21,1372
38,60,20,10,10,695.4
38,61,8,4,4,0
38,62,20,10,10,566
38,63,15,8,7,411.3
38,64,56,31,25,2195.8
38,65,19,9,10,544
38,68,7,4,3,202.3
38,69,19,9,10,403.5
38,70,3,1,2,0
38,71,5,3,2,95
38,72,14,9,5,492.7
38,73,30,16,14,1062
38,74,42,23,19,1600.2
38,75,50,27,23,1618.8000000000002
38,76,22,12,10,777.5
38,77,48,25,23,1923.6
38,78,7,4,3,323
38,79,33,22,11,1082.7
38,80,45,26,19,1794.5
38,81,53,26,27,1772.4
38,82,56,32,24,1766.4
38,83,34,21,13,1340.9
38,84,124,68,56,4910.2
38,85,21,9,12,868
38,93,128,63,65,4496.9
38,94,9,5,4,278.1
38,96,258,124,134,9565.8
38,97,178,100,78,6669.099999999999
38,98,142,73,69,5100.6
38,99,13,7,6,494
38,100,61,30,31,1899.8
38,101,16,6,10,636
38,102,106,56,50,4445.2
38,107,191,85,106,8164.5
38,108,8,4,4,256.9
38,109,7,5,2,165.2
38,110,7,5,2,312.9
38,111,7,4,3,0
38,112,7,4,3,174.3
38,113,63,36,27,1924.2
38,114,119,58,61,4706.6
38,115,110,52,58,4639.299999999999
38,116,13,5,8,444.6
38,117,70,38,32,2709.2
38,118,26,10,16,844.8
38,119,34,17,17,1128.6
38,120,93,46,47,3690.4
38,121,56,31,25,2366.4
38,124,17,7,10,810.9
38,125,23,13,10,989.6
39,52,21,12,9,812.7
39,53,20,7,13,738
39,54,16,9,7,612.8
39,55,6,3,3,136.2
39,56,42,21,21,1167.6
39,57,16,6,10,598.4
39,58,47,24,23,2079
39,59,51,31,20,1935.3
39,60,35,18,17,1228.2
39,61,135,66,69,4860.1
39,62,81,49,32,2957.7
39,63,2,1,1,0
39,64,12,8,4,482.4
39,65,61,36,25,2418.5
39,66,19,8,11,507.3
39,68,27,13,14,550
39,69,37,20,17,1396.4
39,70,28,15,13,779.1
39,71,2,0,2,0
39,72,49,25,24,1912.5
39,74,41,21,20,1531.4
39,75,7,4,3,242.2
39,76,23,15,8,760.2
39,78,17,10,7,685.8
39,80,56,31,25,1994.6999999999998
39,81,9,5,4,212.1
39,82,20,11,9,743.4
39,83,1,1,0,0
39,84,8,6,2,368
39,87,1,0,1,0
39,89,3,1,2,0
39,90,143,73,70,6377.8
39,91,279,134,145,10546.2
39,94,6,3,3,415.8
39,96,24,13,11,1128
39,97,719,362,357,29797.899999999998
39,98,108,58,50,3706.8999999999996
39,100,43,23,20,1935.3
39,101,8,3,5,321
39,102,54,30,24,2560.5
39,107,56,33,23,1947.6
39,111,1,1,0,0
39,114,13,8,5,279.9
39,115,10,6,4,451
39,116,40,21,19,1484
39,119,4,3,1,0
39,121,559,283,276,19722.2
39,122,13,9,4,429
39,124,8,4,4,261.8
39,127,7,2,5,289.1
40,51,5,3,2,205
40,52,17,9,8,889.7
40,54,3,2,1,0
40,55,21,11,10,831.9000000000001
40,58,6,2,4,0
40,60,18,12,6,685.3
40,61,13,7,6,500.5
40,62,35,16,19,1489.1
40,63,117,61,56,3754.4000000000005
40,64,363,183,180,13038.4
40,66,37,19,18,1496.6999999999998
40,67,12,6,6,307.2
40,70,3,2,1,0
40,71,5,4,1,221
40,73,13,6,7,260
40,74,11,6,5,585.2
40,75,11,5,6,536.8
40,76,36,19,17,1228.5
40,77,2,0,2,0
40,78,18,11,7,495.4
40,80,5,4,1,131
40,81,2,1,1,0
40,82,58,29,29,2297.8
40,83,125,67,58,4684.5
40,84,9,7,2,383.4
40,86,90,52,38,4012.8999999999996
40,87,2,1,1,0
40,88,13,6,7,392.6
40,89,227,117,110,8682.4
40,90,1807,920,887,60963.9
40,91,992,490,502,38158.2
40,92,10,5,5,338
40,93,21,9,12,896.7
40,94,28,15,13,1185.9
40,95,199,102,97,7055.1
40,96,79,40,39,3436.5
40,100,11,6,5,418.4
40,101,28,15,13,1090.6
40,102,22,12,10,760.5
40,103,16,9,7,621.6
40,107,297,149,148,12902.499999999998
40,108,1,1,0,0
40,114,5,3,2,145
40,115,6,3,3,235.2
40,116,46,26,20,1938.3
40,117,15,8,7,874.5
40,118,12,6,6,408
40,119,115,70,45,3974
40,120,16,6,10,647.4
40,121,244,126,118,8641.4
40,122,100,63,37,3605
40,123,60,38,22,2405.2
40,124,13,7,6,430.3
41,51,8,3,5,348.8
41,52,3,2,1,0
41,55,2,2,0,0
41,56,8,4,4,220
41,57,2,1,1,0
41,58,2,1,1,0
41,60,156,81,75,5605.8
41,61,25,13,12,530.2
41,62,3,2,1,0
41,63,6,3,3,246
41,64,128,61,67,4784
41,65,63,28,35,2473.5
41,66,347,167,180,14941.6
41,67,304,159,145,9748.900000000001
41,68,14,7,7,693
41,70,73,43,30,2530.7
41,74,13,7,6,401.7
41,75,41,25,16,1462
41,77,648,336,312,21728.9
41,78,6,2,4,172.2
41,79,9,6,3,290.7
41,80,39,19,20,1394.3
41,81,501,256,245,17702.5
41,83,3,1,2,0
41,85,23,12,11,636
41,86,17,12,5,504
41,88,252,135,117,9925.599999999999
41,89,107,54,53,4138.200000000001
41,90,70,37,33,2465.1
41,91,33,19,14,1154.2
41,92,57,31,26,2191.2
41,93,225,126,99,8713.9
41,94,4,2,2,0
41,95,38,21,17,1407
41,96,13,8,5,641.3
41,97,1,1,0,0
41,98,16,8,8,545.6
41,99,27,13,14,774.9
41,100,11,6,5,467.5
41,101,13,8,5,418.6
41,107,68,36,32,2471.1
41,108,11,7,4,452.9
41,109,3,1,2,0
41,117,14,5,9,389.2
41,118,194,100,94,7445.299999999999
41,119,4,2,2,0
41,120,103,55,48,3685.5
41,121,980,493,487,38159.7
41,122,207,117,90,7351.9
41,123,3,1,2,0
41,124,32,17,15,1454.4
41,125,25,17,8,651
41,126,45,31,14,1680.8
42,49,8,4,4,380
42,50,66,37,29,2764.2
42,51,3,2,1,0
42,52,2,1,1,0
42,54,2,1,1,0
42,55,5,3,2,226
42,56,5,3,2,0
42,59,10,5,5,136
42,60,80,46,34,3256
42,61,145,84,61,5793.4
42,64,2,1,1,0
42,65,3,2,1,0
42,66,18,10,8,743.4
42,67,416,210,206,12559.2
42,68,23,13,10,670
42,70,2,1,1,0
42,74,9,4,5,236.7
42,75,21,12,9,708.2
42,77,287,152,135,9442.3
42,78,62,30,32,2218.2
42,81,34,19,15,1538.8000000000002
42,83,51,28,23,1606.7
42,84,37,18,19,1550.3
42,85,8,6,2,0
42,86,2,1,1,0
42,87,2,1,1,0
42,88,991,481,510,37667.4
42,89,236,124,112,7117
42,90,22,13,9,868
42,91,97,48,49,3597.7
42,92,128,68,60,4456.6
42,93,159,85,74,6225
42,94,36,20,16,1679.4
42,96,8,4,4,447.2
42,97,4,1,3,0
42,98,76,38,38,3068.2000000000003
42,99,13,7,6,470.6
42,100,33,17,16,1164
42,101,16,8,8,735
42,102,20,10,10,816.4
42,103,13,7,6,769.6
42,110,12,5,7,403
42,111,6,3,3,0
42,114,32,14,18,825.6
42,115,104,48,56,4125.8
42,116,8,5,3,360
42,117,402,211,191,15679.800000000001
42,118,220,105,115,9715.900000000001
42,119,36,19,17,1502.7
42,121,125,66,59,4919.8
42,122,26,13,13,1037.5
42,123,25,16,9,1065
42,124,14,7,7,561.2
42,126,18,9,9,814.5
42,127,16,5,11,839.2
43,49,11,6,5,446.6
43,51,3,1,2,0
43,52,5,3,2,174
43,59,5,2,3,0
43,60,66,33,33,2814.1000000000004
43,61,56,33,23,1971.9
43,62,1,1,0,0
43,64,17,9,8,575.1
43,66,4,3,1,0
43,68,31,15,16,1154.8
43,69,11,7,4,367.4
43,81,120,65,55,5443.2
43,82,25,10,15,874.4000000000001
43,83,12,6,6,381.6
43,87,374,192,182,12658.8
43,88,3928,1947,1981,148130.8
43,89,1229,626,603,37545.2
43,90,3,1,2,0
43,91,187,94,93,6898.900000000001
43,92,33,20,13,1534
43,93,108,51,57,4001.7
43,94,30,11,19,692.4000000000001
43,95,5,1,4,76
43,97,13,8,5,257.4
43,98,8,5,3,408.8
43,99,3,2,1,0
43,100,9,4,5,396
43,102,20,10,10,784
43,103,8,5,3,324
43,106,20,11,9,995.4
43,107,58,24,34,2467.2
43,108,20,11,9,844
43,114,77,35,42,2549.5
43,115,362,200,162,14557.4
43,116,55,28,27,1571.9
43,118,14,7,7,460.6
43,121,19,11,8,753.0999999999999
43,122,17,8,9,642.6
43,123,207,107,100,8266.5
43,124,6,4,2,331.8
43,127,23,12,11,698
44,49,129,62,67,5888.4
44,50,40,23,17,1209.2
44,51,22,11,11,735.1
44,52,2,1,1,0
44,54,2,1,1,0
44,59,8,5,3,302.4
44,60,3,2,1,0
44,61,58,27,31,2401.3
44,62,31,19,12,1065.2
44,67,22,11,11,846.4
44,68,30,16,14,971.2
44,69,20,9,11,980
44,71,6,4,2,225
44,78,4,2,2,0
44,79,16,11,5,697.6
44,80,18,7,11,680.4
44,81,352,174,178,12539.3
44,82,86,45,41,3801.2
44,83,20,10,10,605.3
44,84,5,3,2,308
44,86,42,23,19,1318.4
44,87,54,30,24,2430
44,88,2,1,1,0
44,91,10,6,4,279
44,93,9,6,3,198
44,94,35,17,18,1620.5
44,95,44,22,22,1298.5
44,96,104,52,52,3693.3
44,97,9,6,3,384.3
44,98,41,19,22,1608.1999999999998
44,99,9,5,4,280.8
44,100,17,12,5,604.4
44,102,14,9,5,304.8
44,103,9,5,4,547.2
44,106,2,1,1,0
44,108,15,8,7,672
44,109,2,2,0,0
44,112,1,1,0,0
44,114,41,18,23,1270.5
44,116,105,54,51,4162.4
44,117,67,33,34,2329
44,123,156,92,64,6158.2
44,124,245,119,126,10516.6
44,125,68,37,31,2478.6
45,48,136,73,63,5168
45,49,1006,492,514,38540.8
45,50,1187,582,605,48278.4
45,51,42,24,18,1603.8
45,52,28,15,13,789.6
45,53,24,11,13,1031.7
45,54,6,4,2,0
45,55,13,6,7,533.1
45,56,11,6,5,293.3
45,57,44,24,20,1631.6
45,58,12,6,6,338
45,59,5,2,3,298
45,60,1,0,1,0
45,61,15,9,6,477.6
45,62,25,17,8,720.8
45,65,5,3,2,302
45,69,19,10,9,742.9
45,70,13,7,6,552.2
45,71,20,12,8,958.2
45,72,6,4,2,205.8
45,77,72,40,32,2534.4
45,78,11,4,7,533.5
45,79,111,56,55,4247.6
45,81,148,77,71,4179.8
45,83,5,3,2,235
45,89,18,10,8,789
45,94,57,35,22,2348.7
45,95,11,5,6,347.6
45,96,127,69,58,4749.8
45,97,55,28,27,1636.2
45,98,17,8,9,568.5999999999999
45,99,31,19,12,1155.6
45,100,12,6,6,330.3
45,101,11,6,5,395.2
45,102,5,1,4,160
45,103,7,4,3,153
45,105,23,14,9,972.3
45,106,152,77,75,7104.8
45,107,9,5,4,227.2
45,108,1,0,1,0
45,109,19,10,9,677.9
45,110,73,39,34,2245.4
45,111,1,1,0,0
45,113,16,6,10,563.2
45,114,80,41,39,3628.4
45,115,37,18,19,1572.6
45,116,19,8,11,693
45,117,28,13,15,1235.7
45,118,5,2,3,196
45,123,38,16,22,1174.2
45,124,809,384,425,33078.4
45,125,274,131,143,9763.6
45,127,23,15,8,1012
46,47,2,2,0,0
46,48,14,10,4,855.4
46,49,65,37,28,2444.4
46,50,106,48,58,4059.9
46,51,19,12,7,726.4
46,52,3,2,1,0
46,55,7,3,4,284.2
46,56,4,3,1,0
46,57,4,3,1,0
46,58,3,1,2,0
46,61,19,8,11,707.5
46,62,6,4,2,184.8
46,72,38,19,19,1365.3
46,76,31,17,14,1077.7
46,77,24,12,12,861
46,79,16,10,6,742
46,80,21,11,10,804.3
46,81,10,5,5,379
46,82,13,8,5,525.2
46,84,3,1,2,0
46,90,2,1,1,0
46,95,55,28,27,2042.6
46,96,44,23,21,1626
46,97,4,2,2,0
46,98,54,29,25,2476.2
46,99,89,47,42,3429.3
46,100,5,3,2,288
46,101,5,2,3,156
46,102,13,7,6,412
46,105,3,1,2,0
46,106,5,2,3,187
46,107,4,3,1,0
46,108,1,1,0,0
46,109,6,2,4,195
46,110,33,13,20,1401.7
46,111,14,9,5,593.6
46,112,7,5,2,219
46,113,26,13,13,1175
46,114,3,2,1,0
46,115,28,16,12,1259.1
46,118,5,4,1,267
46,123,117,66,51,4361.8
46,124,296,163,133,11238.5
46,125,48,25,23,1660.8
46,127,5,3,2,168
47,45,2,1,1,0
47,46,5,3,2,195
47,51,10,5,5,631
47,52,7,4,3,193.2
47,53,8,5,3,200.8
47,54,2,1,1,0
47,55,2,1,1,0
47,56,10,5,5,405
47,57,7,5,2,142.1
47,60,42,22,20,1639.4
47,61,18,7,11,533.4
47,75,215,116,99,8019.5
47,76,36,20,16,1756.8
47,80,38,19,19,1198.4
47,84,11,7,4,347.6
47,92,5,3,2,251
47,94,1,1,0,0
47,95,164,90,74,6553.8
47,96,36,20,16,1018.4
47,97,40,22,18,1242.2
47,98,44,23,21,1174.8
47,99,86,41,45,3460
47,102,47,27,20,1988.6
47,104,14,8,6,628.8
47,105,21,11,10,628.5
47,106,4,2,2,0
47,107,6,2,4,235.8
47,108,24,11,13,659.3
47,109,37,24,13,1250.7
47,110,23,12,11,830
47,111,11,6,5,598.4
47,113,15,7,8,795
47,114,4,2,2,0
47,118,10,4,6,428.8
47,123,93,51,42,3401.1
47,124,74,31,43,3047.7
47,125,72,35,37,2754.9
48,45,3,2,1,0
48,46,29,12,17,1704.1
48,52,70,35,35,2297
48,53,1,0,1,0
48,56,28,15,13,1104
48,57,33,18,15,1375.7
48,58,28,12,16,1145.4
48,59,83,42,41,2842.1
48,60,141,72,69,5296.2
48,61,13,6,7,427
48,63,6,3,3,397.8
48,75,252,130,122,6633.1
48,77,10,6,4,367
48,85,9,5,4,256.2
48,92,3,2,1,0
48,94,10,9,1,331.8
48,95,254,130,124,9684
48,96,14,9,5,582.4
48,99,537,262,275,20982.6
48,100,45,18,27,1764
48,101,35,21,14,1412
48,102,59,29,30,2533.6
48,106,7,4,3,221.9
48,108,1,1,0,0
48,109,3,1,2,0
48,110,2,1,1,0
48,113,9,6,3,343.2
48,114,10,6,4,319
48,123,17,10,7,575.4
48,124,13,8,5,835.9
48,125,32,16,16,1163.8
48,126,7,3,4,277.9
48,127,5,4,1,126
49,46,177,86,91,7109.4
49,52,75,36,39,2617.8999999999996
49,53,4,2,2,0
49,63,1,1,0,0
49,67,25,12,13,897.5
49,70,4,2,2,0
49,72,24,11,13,680
49,73,9,5,4,248.4
49,74,32,18,14,1527.6
49,77,64,31,33,2723.6
49,81,52,31,21,1783.6
49,93,9,4,5,327.6
49,94,61,30,31,2222.1
49,95,57,31,26,2057.4
49,98,14,9,5,407.4
49,99,100,48,52,3864.7999999999997
49,100,6,2,4,327
49,104,24,10,14,868.4
49,105,45,28,17,1830
49,107,18,10,8,612
49,108,5,1,4,76
49,109,2,1,1,0
49,110,1,1,0,0
49,113,24,13,11,1042.8
49,114,7,4,3,212
49,122,3,2,1,0
49,123,1,1,0,0
49,125,19,11,8,651.7
49,126,43,23,20,1814
50,45,14,8,6,745
50,52,6,3,3,223.8
50,53,2,2,0,0
50,67,13,6,7,177.3
50,68,13,8,5,459
50,72,15,7,8,679.5
50,73,27,11,16,969.3
50,77,9,5,4,287.1
50,93,25,14,11,793.5
50,94,7,2,5,261.1
50,98,11,6,5,252.8
50,99,7,4,3,261.1
50,100,7,4,3,275.1
50,104,5,3,2,69
50,105,225,104,121,8922
50,106,28,14,14,1229.6
50,107,9,4,5,147
50,108,4,3,1,0
50,112,1,1,0,0
50,113,8,5,3,310.4
50,114,4,1,3,0
50,122,4,1,3,0
50,126,28,15,13,1225.7
50,127,82,43,39,2597
51,42,95,54,41,4541
51,43,104,53,51,3910.4
51,45,11,6,5,412.2
51,47,5,3,2,0
51,51,1,1,0,0
51,52,3,1,2,0
51,54,2,2,0,0
51,64,1,1,0,0
51,68,15,7,8,323.4
51,75,16,9,7,580.8
51,77,23,14,9,800.1
51,78,1,1,0,0
51,87,1,1,0,0
51,93,8,5,3,285
51,94,7,4,3,427
51,99,21,9,12,654.8
51,104,20,11,9,843.9000000000001
51,105,41,20,21,2076.3
51,106,19,13,6,385.5
51,108,10,5,5,271.2
51,110,4,2,2,0
51,113,4,2,2,0
51,115,21,10,11,502.5
51,126,16,10,6,421.70000000000005
51,127,26,13,13,898.8
52,34,262,141,121,9746.4
52,35,867,458,409,35140.200000000004
52,36,53,27,26,2024
52,41,6,3,3,265.2
52,42,117,60,57,5275.1
52,43,52,25,27,2754.4
52,45,59,32,27,2327.6
52,47,1,1,0,0
52,50,2,1,1,0
52,57,6,4,2,194
52,58,19,8,11,882.8
52,59,226,123,103,8231.8
52,60,52,32,20,1496.1
52,64,3,3,0,0
52,75,6,3,3,319.2
52,87,4,4,0,0
52,94,16,6,10,500.8
52,99,8,3,5,316.2
52,100,7,3,4,324.1
52,102,7,4,3,352.8
52,103,7,3,4,221.2
52,104,4,2,2,0
52,106,10,5,5,157.2
52,111,11,6,5,309.1
52,113,1045,508,537,42240
52,115,1,0,1,0
52,127,19,12,7,720.1
53,33,9,5,4,449.1
53,34,100,58,42,3414.7
53,35,45,22,23,1620
53,36,209,111,98,8624.7
53,37,57,24,33,2208.8
53,38,1,0,1,0
53,41,140,67,73,6426
53,42,29,15,14,1209.2
53,43,3,2,1,0
53,46,2,1,1,0
53,47,3,2,1,0
53,48,5,2,3,133
53,50,6,3,3,175.8
53,53,49,24,25,2094.8
53,54,429,208,221,16874.7
53,55,1339,646,693,50696.4
53,56,36,14,22,1429.2
53,57,2,1,1,0
53,58,124,71,53,5127.6
53,59,42,27,15,1260
53,61,6,2,4,196.8
53,62,28,19,9,1050
53,64,1,1,0,0
53,65,5,3,2,179
53,76,10,4,6,343
53,86,5,2,3,356
53,87,2,1,1,0
53,94,1,1,0,0
53,99,9,3,6,288
53,106,3,1,2,0
53,107,22,10,12,704
53,108,16,7,9,578.4
53,112,99,52,47,3369.2
53,113,131,64,67,4042.3999999999996
53,116,2,1,1,0
53,117,2,1,1,0
53,121,7,4,3,214.9
53,126,1,1,0,0
53,127,4,3,1,0
54,33,26,13,13,1128.4
54,34,111,51,60,4215.5
54,35,191,106,85,7312.900000000001
54,36,194,104,90,7264.2
54,37,41,24,17,1396.6
54,38,16,9,7,727.2
54,42,1,0,1,0
54,43,30,16,14,1293.6
54,45,8,5,3,199.2
54,46,26,13,13,1294.8
54,50,7,4,3,329
54,51,1,1,0,0
54,52,52,27,25,2214.4
54,54,193,100,93,7861.6
54,55,118,56,62,4354.2
54,58,12,6,6,471.6
54,59,11,6,5,268.4
54,65,8,4,4,284.8
54,68,2,1,1,0
54,86,2,1,1,0
54,99,46,25,21,1735.6
54,100,29,13,16,1330
54,107,12,6,6,523
54,108,15,8,7,556.5
54,111,2,2,0,0
54,112,75,42,33,2786.0999999999995
54,115,34,22,12,1471.2
54,116,8,4,4,266.4
54,119,1,1,0,0
54,121,86,48,38,3675.7
54,122,2,1,1,0
55,33,68,38,30,2774.5
55,34,1308,616,692,56971.6
55,35,457,223,234,17752.199999999997
55,36,106,55,51,4068
55,37,2,2,0,0
55,38,6,3,3,0
55,39,38,17,21,1288.2
55,42,177,99,78,7353.6
55,43,11,6,5,570.9
55,44,44,24,20,2091.7
55,45,642,310,332,28276.800000000003
55,46,1696,851,845,69854.6
55,47,23,11,12,1166.1
55,48,25,14,11,979.2
55,49,24,15,9,1249.8
55,50,22,13,9,1024.8
55,51,2,2,0,0
55,52,52,24,28,2246.4
55,54,19,7,12,725.8
55,60,3,2,1,0
55,65,2,1,1,0
55,66,7,4,3,170
55,96,4,1,3,0
55,104,1,0,1,0
55,111,8,6,2,0
55,116,22,12,10,785.5999999999999
55,118,6,4,2,333
55,121,751,372,379,30245.1
55,122,174,86,88,7375.200000000001
56,33,93,46,47,3380.8
56,34,290,137,153,9832.8
56,35,443,224,219,15387.9
56,36,44,25,19,1562
56,38,1,0,1,0
56,39,6,4,2,126
56,42,2,1,1,0
56,43,2,1,1,0
56,44,55,27,28,2120.2000000000003
56,45,1611,835,776,60024.4
56,46,2089,1035,1054,84968.8
56,47,183,97,86,7935.6
56,48,61,32,29,2306.7
56,49,32,17,15,1395
56,50,1,0,1,0
56,52,400,215,185,16107.099999999999
56,53,200,107,93,7260
56,54,5,3,2,184
56,101,6,3,3,0
56,102,3,1,2,0
56,103,22,10,12,904.2
56,111,53,24,29,2343.8
56,114,2,1,1,0
56,116,23,11,12,840
56,119,7,4,3,193.9
56,121,145,74,71,7195.3
56,122,974,461,513,45840.9
56,123,129,71,58,4876.8
57,32,1,0,1,0
57,33,154,79,75,5629.799999999999
57,34,1144,589,555,44371.8
57,35,74,44,30,2634.6
57,36,4,1,3,0
57,40,4,2,2,0
57,41,4,2,2,0
57,43,4,3,1,0
57,44,30,17,13,1203.5
57,45,45,26,19,1633.3
57,46,1,0,1,0
57,47,50,23,27,2569.6000000000004
57,49,44,22,22,1881.2
57,50,3,2,1,0
57,52,11,4,7,379.5
57,53,98,53,45,3171.9
57,54,4,2,2,0
57,55,5,3,2,328
57,56,5,4,1,93
57,57,10,6,4,308
57,66,1,0,1,0
57,103,43,24,19,1664.1
57,104,34,17,17,1215
57,105,1,1,0,0
57,106,33,18,15,1600.3
57,111,89,44,45,4235.7
57,112,1,1,0,0
57,113,6,5,1,262.8
57,114,4,1,3,0
57,116,15,8,7,540.0999999999999
57,121,256,128,128,10510.8
57,122,1991,987,1004,78022.70000000001
57,123,40,20,20,1352
57,124,4,2,2,0
58,32,14,7,7,1020.6
58,33,291,146,145,12664.2
58,34,1870,914,956,79237.3
58,35,34,19,15,1088.8999999999999
58,37,19,11,8,604.2
58,39,9,5,4,312
58,40,2,1,1,0
58,41,2,1,1,0
58,45,12,8,4,227
58,46,20,9,11,840
58,47,2,1,1,0
58,49,8,3,5,229.2
58,50,14,7,7,359.7
58,51,16,7,9,370.5
58,52,13,9,4,468
58,53,2,1,1,0
58,55,3,2,1,0
58,58,1,1,0,0
58,61,18,13,5,599
58,63,3,2,1,0
58,66,17,6,11,521.3
58,109,6,4,2,172.8
58,112,102,44,58,3935.9999999999995
58,115,4,2,2,0
58,122,94,48,46,3775.5000000000005
58,123,6,3,3,188
59,34,138,69,69,5535.900000000001
59,36,8,5,3,387.8
59,37,25,9,16,1000.5
59,39,44,19,25,1661.8000000000002
59,40,19,9,10,548.8
59,41,3,2,1,0
59,42,6,4,2,316.8
59,43,3,2,1,0
59,44,27,13,14,1476.7
59,46,5,1,4,118
59,48,3,2,1,0
59,49,7,3,4,221.2
59,50,6,4,2,334.2
59,51,9,5,4,462.6
59,53,26,13,13,1042.6
59,57,3,1,2,0
59,59,51,27,24,1570.2
59,60,14,6,8,469
59,61,31,17,14,1646.1
59,62,19,11,8,424.5
59,66,139,69,70,4783.9
59,106,1,1,0,0
59,112,348,171,177,14229.9
59,116,7,3,4,396.2
59,121,2,2,0,0
59,122,15,7,8,498
59,123,7,4,3,252
60,32,2,1,1,0
60,33,47,23,24,2051
60,34,72,36,36,2871.9
60,35,4,2,2,0
60,36,21,10,11,652.4000000000001
60,39,4,3,1,0
60,41,9,7,2,367.2
60,42,12,5,7,329
60,43,287,145,142,11077.3
60,44,287,144,143,11128.000000000002
60,45,1,1,0,0
60,46,9,5,4,243.9
60,47,10,6,4,302.4
60,48,24,12,12,909.6
60,49,24,16,8,850.5
60,50,9,5,4,83
60,51,8,4,4,340.8
60,52,14,5,9,572.6
60,54,12,6,6,198.9
60,55,11,5,6,446.6
60,56,5,3,2,200
60,57,25,17,8,830.4
60,62,55,26,29,2282
60,65,58,34,24,1873.4
60,66,667,320,347,27262.7
60,67,50,30,20,1460.6999999999998
60,68,8,2,6,320.8
60,69,21,13,8,1015.2
60,88,2,1,1,0
60,112,194,92,102,8250.3
60,113,5,2,3,317
61,33,33,18,15,1556.7
61,34,108,61,47,4389.099999999999
61,35,20,12,8,691.3
61,39,25,15,10,833.7
61,41,7,4,3,385.7
61,42,6,3,3,0
61,44,26,15,11,1036.4
61,47,1,1,0,0
61,49,89,42,47,2692.8
61,50,40,21,19,1800
61,51,57,33,24,2002.5
61,52,49,26,23,2247.8
61,54,8,4,4,169.8
61,55,4,2,2,0
61,63,3,2,1,0
61,64,15,7,8,631.5
61,67,85,40,45,3320
61,69,25,13,12,881
61,71,4,3,1,0
61,74,10,4,6,515
61,88,8,6,2,378
61,113,6,2,4,255
61,123,52,23,29,2400.1
61,124,4,1,3,0
62,31,6,4,2,256.2
62,32,9,3,6,314.3
62,33,21,11,10,1132.5
62,34,100,54,46,3464.1
62,35,34,17,17,1289.9
62,36,2,1,1,0
62,40,1,1,0,0
62,41,11,4,7,179.2
62,42,1,1,0,0
62,43,9,4,5,381.6
62,44,175,88,87,6240.3
62,49,14,8,6,469
62,51,5,4,1,158
62,52,32,17,15,1058.4
62,67,5,3,2,125
62,70,23,14,9,809.6
62,73,11,5,6,372.6
62,74,8,6,2,280
62,75,24,14,10,990
62,76,14,10,4,567
62,113,5,2,3,325
63,28,1,0,1,0
63,30,11,6,5,315.7
63,31,3,1,2,0
63,32,36,17,19,1785.2
63,33,26,13,13,860.3
63,34,107,46,61,3977.1000000000004
63,35,25,15,10,1029.2
63,36,29,18,11,815
63,37,4,2,2,0
63,38,5,2,3,98
63,40,11,6,5,201
63,44,239,114,125,9984.5
63,45,87,45,42,3734.9
63,56,1,0,1,0
63,59,1,1,0,0
63,74,6,2,4,202.8
63,75,18,11,7,526.5
63,76,9,5,4,0
63,77,5,3,2,230
63,112,6,3,3,211.2
63,113,49,24,25,1614.6
63,114,3,1,2,0
63,116,1,1,0,0
64,29,120,61,59,5081.8
64,30,48,23,25,1829.7
64,31,47,25,22,1600.8
64,32,6,3,3,0
64,33,12,7,5,160.8
64,34,33,17,16,1221.8
64,35,17,13,4,448.5
64,36,9,5,4,145
64,37,4,1,3,0
64,38,9,5,4,404.1
64,39,18,10,8,604.8
64,40,4,2,2,0
64,41,2,1,1,0
64,43,5,3,2,146
64,44,36,16,20,995.1
64,45,980,462,518,39153.799999999996
64,46,299,148,151,13697.900000000001
64,49,29,19,10,1031
64,50,26,11,15,921.8
64,51,35,20,15,1345.8999999999999
64,52,5,2,3,278
64,53,15,6,9,477.1
64,54,31,13,18,852.5
64,55,3,1,2,0
64,56,9,6,3,254.7
64,57,27,11,16,946.4
64,58,5,3,2,0
64,60,25,13,12,1105
64,61,7,4,3,230
64,77,3,1,2,0
64,112,12,5,7,424.8
64,116,5,2,3,186
65,27,19,11,8,984.3
65,28,4,2,2,0
65,29,2,1,1,0
65,31,17,10,7,466.7
65,32,38,21,17,1421.5
65,33,140,74,66,4481.2
65,34,320,157,163,10982.4
65,35,62,31,31,2559.4
65,36,242,121,121,8551.5
65,37,98,49,49,3241.4
65,38,43,25,18,1699.7
65,39,6,5,1,259.8
65,40,10,6,4,259.8
65,42,10,4,6,0
65,43,9,5,4,161
65,45,126,62,64,5445
65,46,1204,620,584,44563
65,47,113,64,49,4317.1
65,48,94,46,48,3605.7
65,49,285,150,135,11084.800000000001
65,50,83,42,41,3065.7
65,51,21,10,11,746
65,52,12,6,6,246.4
65,54,22,11,11,644.4
65,55,13,6,7,172.2
65,56,18,10,8,631.8
65,57,102,42,60,4997.7
65,58,22,10,12,680.8
65,59,8,6,2,420.8
65,60,4,3,1,0
65,62,5,5,0,0
65,63,26,16,10,953
65,66,6,3,3,220.8
65,73,3,2,1,0
65,77,48,21,27,1478.4
65,78,42,27,15,1913.7
65,79,42,21,21,1480.1
65,117,3,2,1,0
66,27,22,11,11,1280.4
66,28,24,13,11,1126.1000000000001
66,29,21,9,12,731.6
66,31,13,5,8,399.8
66,32,10,4,6,214.2
66,33,52,26,26,1632.3000000000002
66,34,310,165,145,9532.4
66,35,2229,1072,1157,83971
66,36,329,169,160,13181.1
66,37,93,49,44,3247.5
66,38,26,11,15,950.6
66,39,35,17,18,1237.8999999999999
66,42,10,5,5,434
66,45,6,2,4,294
66,46,66,40,26,2140.3
66,47,48,25,23,1573.4
66,48,16,8,8,444.8
66,50,5,3,2,194
66,51,65,33,32,1985.5
66,52,3,2,1,0
66,53,13,5,8,466.2
66,54,8,4,4,400.8
66,55,12,7,5,392.4
66,56,15,9,6,473
66,57,35,20,15,1144.9
66,58,13,6,7,470.2
66,59,2,1,1,0
66,63,2,2,0,0
66,64,19,11,8,511.5
66,77,9,5,4,229.8
66,78,12,7,5,536.3
66,79,88,47,41,3379.7000000000003
66,117,7,4,3,266
66,118,12,8,4,439.2
67,28,7,3,4,296.8
67,29,26,15,11,920.4
67,30,91,47,44,3094
67,31,10,5,5,397.8
67,32,20,12,8,632
67,33,32,16,16,959.2
67,34,4,3,1,0
67,35,317,159,158,11754.999999999998
67,36,1737,855,882,66139.20000000001
67,37,45,22,23,1667.6999999999998
67,38,10,4,6,300.6
67,39,4,3,1,0
67,41,2,2,0,0
67,42,3,1,2,0
67,44,6,2,4,0
67,46,14,5,9,449.4
67,47,132,71,61,5271.1
67,48,148,79,69,5005.4
67,49,62,36,26,2403
67,50,32,17,15,808.5
67,51,1,0,1,0
67,53,7,5,2,385
67,54,38,23,15,1432
67,55,22,8,14,906.2
67,56,30,15,15,1080.9
67,57,42,21,21,1509.7
67,65,16,8,8,572.6
67,79,25,11,14,1100
67,80,15,9,6,607.5
67,81,8,4,4,264
67,84,4,3,1,0
67,124,3,2,1,0
68,30,607,301,306,24034.5
68,31,35,21,14,1545.9
68,32,15,10,5,751.5
68,33,28,15,13,1077.2
68,34,10,5,5,0
68,35,10,5,5,186
68,36,575,288,287,20806.100000000002
68,37,30,15,15,901.7
68,38,51,26,25,1504.4
68,39,2,1,1,0
68,40,6,3,3,0
68,41,7,5,2,0
68,42,1,1,0,0
68,43,2,1,1,0
68,44,4,2,2,0
68,47,2,1,1,0
68,50,11,7,4,224.4
68,55,4,2,2,0
68,56,25,14,11,864.2
68,59,9,4,5,314.1
68,81,28,12,16,943.2
68,84,9,5,4,155
68,85,11,8,3,243
68,117,16,8,8,457.2
68,118,1,1,0,0
68,121,5,3,2,197
68,122,3,2,1,0
68,125,10,7,3,262
69,30,88,47,41,2924
69,31,9,5,4,364.7
69,32,20,11,9,826.1
69,33,2,1,1,0
69,34,9,6,3,251.2
69,35,15,9,6,634.2
69,36,27,13,14,617.3
69,39,34,17,17,1147.4
69,40,29,16,13,602.2
69,41,1,1,0,0
69,42,12,8,4,531.6
69,55,5,3,2,127
69,84,3,2,1,0
69,85,8,2,6,132.8
69,116,3,1,2,0
69,117,9,4,5,351.9
69,118,1,1,0,0
69,120,134,70,64,5562.2
69,126,1,0,1,0
70,29,79,39,40,3748.8
70,30,354,187,167,11853.400000000001
70,31,20,9,11,478.9
70,32,2,1,1,0
70,33,35,20,15,1326.7
70,34,9,4,5,468
70,35,21,13,8,706.0999999999999
70,36,25,16,9,866.2
70,37,15,9,6,616
70,39,3,2,1,0
70,40,68,32,36,2199.8
70,41,152,78,74,5039.599999999999
70,44,1,1,0,0
70,51,2,1,1,0
70,56,74,40,34,3050.4
70,57,17,8,9,807.5
70,58,19,12,7,689.4
70,120,8,5,3,348
71,29,6,4,2,354
71,30,48,28,20,1985
71,31,6,4,2,144
71,33,36,20,16,1428.9
71,34,8,5,3,217.8
71,36,7,4,3,179.2
71,37,22,8,14,508.6
71,40,1,0,1,0
71,41,21,11,10,470.8
71,42,64,34,30,2696.4
71,43,28,14,14,1267.8000000000002
71,46,5,3,2,238
71,49,13,8,5,565.5
71,50,30,21,9,1046
71,51,4,1,3,0
71,54,3,2,1,0
71,55,51,24,27,1814.6
71,56,13,7,6,418.5
71,120,10,5,5,384.8
72,29,16,8,8,660.8
72,30,216,112,104,7932.300000000001
72,31,129,65,64,5172.4
72,32,48,23,25,1743.8
72,33,9,4,5,372.6
72,34,7,3,4,373.1
72,39,5,3,2,178
72,44,11,6,5,537.9
72,45,53,24,29,2080
72,46,75,40,35,3337.9
72,47,52,25,27,2154
72,48,195,99,96,7388.6
72,49,23,13,10,816
72,50,19,11,8,870.8
72,51,8,4,4,289
72,53,55,27,28,1892.8
72,54,128,62,66,4343
72,55,111,60,51,4001.2
72,57,2,1,1,0
72,119,6,3,3,103.2
72,120,18,11,7,860.4
73,29,28,16,12,1200.4
73,30,10,5,5,112
73,31,598,276,322,24486.3
73,32,992,494,498,40592
73,33,24,12,12,992.7
73,35,4,3,1,0
73,36,7,3,4,100.8
73,37,4,2,2,0
73,38,8,3,5,451.2
73,42,4,2,2,0
73,43,5,2,3,158
73,46,11,4,7,272.8
73,47,3,2,1,0
73,48,27,16,11,787.2
73,49,78,39,39,2705.5
73,50,3,2,1,0
73,51,10,6,4,364
73,52,25,13,12,1117.4
73,53,227,116,111,9602.2
73,54,158,87,71,4937.4
74,27,2,2,0,0
74,28,18,11,7,720.8
74,29,147,71,76,5447.8
74,30,65,32,33,2400.6
74,31,82,41,41,3088
74,32,91,51,40,3105.4
74,33,171,86,85,6349.2
74,34,93,46,47,3403.4
74,35,11,5,6,424
74,36,6,2,4,226.2
74,38,11,4,7,313.8
74,39,7,5,2,382.2
74,40,23,11,12,817.4
74,41,1,1,0,0
74,42,19,11,8,501.7
74,45,3,1,2,0
74,46,39,19,20,1262.6
74,48,8,3,5,249.2
74,49,5,2,3,202
74,50,10,7,3,420.3
74,51,10,7,3,329
74,52,44,20,24,1284
75,27,28,14,14,876.4
75,28,149,73,76,5652.5
75,29,115,63,52,4057.7
75,30,103,60,43,3512.4
75,31,13,6,7,577.5
75,32,10,4,6,308.7
75,33,9,5,4,292
75,34,40,20,20,1279.5
75,35,12,7,5,604.8
75,36,65,31,34,2400.6
75,37,48,28,20,1883.1
75,38,129,69,60,4158
75,39,63,32,31,2558.3999999999996
75,40,4,3,1,0
75,41,76,39,37,2885.8
75,43,3,2,1,0
75,45,3,3,0,0
75,46,24,14,10,912
75,49,4,3,1,0
75,52,5,3,2,267
75,56,5,3,2,107
76,27,32,13,19,1374.8
76,28,2049,972,1077,89721.59999999999
76,29,506,259,247,17653.2
76,30,56,26,30,1786.4
76,31,25,17,8,1004.8
76,32,28,15,13,995
76,33,22,13,9,730.4
76,34,7,4,3,283.8
76,35,2,1,1,0
76,36,17,9,8,644.7
76,37,24,11,13,955.2
76,38,1,0,1,0
76,39,3,2,1,0
76,40,21,13,8,656.4
76,41,39,21,18,1209.3
76,42,211,104,107,8383.4
76,43,214,104,110,8166.5
76,44,160,79,81,6252.599999999999
76,45,5,3,2,0
76,47,22,8,14,878.2
76,49,4,2,2,0
76,52,9,5,4,467.1
76,53,25,13,12,692.5
76,54,5,4,1,0
76,55,5,3,2,211
77,27,114,65,49,4774.6
77,28,5584,2709,2875,230179.40000000002
77,29,1026,531,495,34122.6
77,30,58,32,26,2049.9
77,31,47,23,24,1737.7
77,32,21,9,12,563.6
77,33,7,4,3,0
77,34,11,5,6,363
77,35,13,5,8,224.4
77,36,8,3,5,246.4
77,37,8,4,4,332
77,39,13,7,6,335.4
77,40,8,4,4,237
77,41,25,12,13,545.6
77,42,11,7,4,0
77,43,9,5,4,213
77,44,4,2,2,0
77,45,21,9,12,649.8
77,46,79,42,37,2310.1000000000004
77,47,33,16,17,1068
77,48,5,2,3,229
77,49,86,45,41,2840.6
77,50,66,31,35,1769
77,51,16,8,8,501.2
77,56,12,6,6,348
77,57,13,9,4,504.4
78,26,141,72,69,5499
78,27,70,39,31,2868.6
78,28,1999,1008,991,70021.3
78,29,80,49,31,3274.3999999999996
78,30,48,23,25,1197.8
78,32,39,20,19,1230.4
78,33,23,9,14,680
78,34,13,8,5,267
78,35,11,5,6,266.2
78,36,35,20,15,1380.3
78,37,1,1,0,0
78,39,7,2,5,107
78,40,15,9,6,413.1
78,41,26,15,11,898.3
78,42,15,8,7,488
78,43,4,3,1,0
78,45,16,8,8,497
78,46,10,4,6,413
78,47,13,5,8,400.8
78,48,1,1,0,0
78,49,56,29,27,2013.4
78,50,233,114,119,9062.5
78,51,21,9,12,741.3
78,52,16,8,8,612.8
78,53,8,5,3,430.4
78,55,2,2,0,0
78,56,1,1,0,0
78,57,37,16,21,1289.8
78,64,2,1,1,0
78,70,1,1,0,0
79,25,170,86,84,6681.6
79,26,136,63,73,5148.3
79,27,213,101,112,7799.200000000001
79,28,184,98,86,6724.2
79,29,87,42,45,3588.6
79,30,103,46,57,4208.8
79,31,586,280,306,19657.7
79,32,44,20,24,1619.2
79,33,14,7,7,561.4
79,34,16,10,6,484.5
79,35,16,9,7,533.1
79,36,19,9,10,560.1
79,37,4,2,2,0
79,38,1,0,1,0
79,39,39,19,20,1520.4
79,40,8,5,3,360
79,41,40,22,18,1064.4
79,42,1,1,0,0
79,43,7,3,4,295.8
79,44,26,17,9,1030
79,45,10,4,6,372
79,46,17,7,10,549.2
79,47,26,13,13,591.4
79,52,20,8,12,598
79,53,19,10,9,782.8
79,54,16,8,8,603.4
79,55,4,3,1,0
79,56,37,20,17,1270.5
79,58,3,2,1,0
79,60,68,36,32,2514.6
79,61,96,49,47,3832.4
79,70,24,11,13,788.9
79,71,2,1,1,0
80,26,7,3,4,220.2
80,27,149,75,74,5141.3
80,28,80,47,33,3120
80,29,40,21,19,1134.2
80,30,19,12,7,606.1
80,31,96,48,48,4492.8
80,32,124,69,55,4393.5
80,33,164,82,82,5533.8
80,34,16,9,7,654.4
80,36,28,15,13,1015
80,37,212,109,103,8052.6
80,38,178,79,99,6864.2
80,39,60,31,29,2467.7
80,40,191,94,97,7314.599999999999
80,41,23,11,12,942.5999999999999
80,42,2,2,0,0
80,43,43,22,21,1487.5
80,44,7,4,3,252
80,45,9,4,5,234
80,47,27,17,10,1051.1999999999998
80,50,54,26,28,1906.2
80,51,4,2,2,0
80,52,15,7,8,673.5
80,53,58,26,32,2292.3999999999996
80,54,27,15,12,874.8
80,55,12,6,6,385.1
80,56,23,12,11,940.6
80,57,23,13,10,947.1
80,60,106,50,56,3869
80,61,119,52,67,4950.4
80,62,2,1,1,0
80,63,3,2,1,0
80,67,1,1,0,0
80,96,2,1,1,0
81,26,74,35,39,3056.2
81,27,31,14,17,1258.6
81,28,66,36,30,2630.8
81,29,188,96,92,6783
81,30,25,13,12,1024.6
81,31,40,22,18,1332.6999999999998
81,32,5,3,2,224
81,34,19,11,8,528.2
81,35,276,150,126,10153.6
81,36,248,136,112,9366.6
81,38,4,3,1,0
81,40,6,3,3,0
81,42,8,3,5,408
81,43,8,5,3,246
81,44,12,7,5,473
81,45,10,5,5,363
81,46,24,15,9,992
81,47,75,31,44,3525
81,48,16,7,9,598.8
81,49,2,1,1,0
81,50,19,10,9,708.7
81,51,22,8,14,749.2
81,53,4,2,2,0
81,54,2,1,1,0
81,57,6,3,3,139.8
81,58,20,11,9,617
81,62,17,10,7,609.6
81,63,49,28,21,1786.5
81,64,9,5,4,349.2
81,65,1,1,0,0
81,68,2,1,1,0
81,86,2,1,1,0
81,100,3,1,2,0
81,101,6,3,3,172.8
82,27,40,24,16,1850.6
82,28,84,47,37,3378.6000000000004
82,29,7,3,4,240.1
82,30,31,19,12,1289.6
82,31,41,20,21,1854.9
82,32,10,6,4,293.3
82,33,21,10,11,625.3
82,35,40,19,21,1557
82,36,3,1,2,0
82,37,6,4,2,0
82,39,22,9,13,780.3
82,40,9,4,5,300.6
82,41,118,59,59,3835.2
82,42,24,14,10,974.7
82,43,9,4,5,203.7
82,45,1,1,0,0
82,46,9,4,5,230
82,47,5,1,4,156
82,49,3,2,1,0
82,50,25,14,11,1028.6999999999998
82,51,2,2,0,0
82,58,5,3,2,314
82,65,28,14,14,792
82,66,3,2,1,0
82,67,11,7,4,0
82,68,18,9,9,770.4000000000001
82,72,2,0,2,0
82,99,2,1,1,0
82,100,29,14,15,1080.6
82,101,3,1,2,0
82,102,121,62,59,4728.3
82,114,18,9,9,785.4
83,27,29,16,13,1147.9
83,28,65,33,32,2748.6000000000004
83,29,69,34,35,2636.9
83,30,21,10,11,601.6
83,31,14,6,8,334.6
83,32,31,16,15,1095.5
83,33,8,4,4,160
83,34,1,1,0,0
83,35,31,17,14,1139
83,37,25,12,13,892.5
83,38,16,8,8,536
83,39,3,2,1,0
83,40,10,4,6,262.4
83,41,30,14,16,1457.1
83,42,51,25,26,1556.6
83,43,27,10,17,1072.9
83,44,44,25,19,1713.6
83,45,46,22,24,1685.2
83,46,10,4,6,266
83,47,18,8,10,506.8
83,48,17,10,7,757.6
83,49,4,2,2,0
83,58,20,12,8,464.4
83,66,2,1,1,0
83,67,5,2,3,0
83,68,41,19,22,1293.6
83,70,11,5,6,294.8
83,87,4,3,1,0
83,98,2,1,1,0
83,102,149,74,75,5623.2
83,103,2,1,1,0
83,113,62,32,30,2041.4
83,114,6,3,3,366
84,27,5,2,3,295
84,28,58,28,30,2166.4
84,29,76,43,33,2958.3
84,30,29,15,14,1157
84,31,61,34,27,2888.3999999999996
84,32,12,7,5,505.9
84,33,6,4,2,249
84,34,6,3,3,265
84,35,10,6,4,330
84,36,2,1,1,0
84,37,18,4,14,561.6
84,38,10,6,4,322
84,39,3,2,1,0
84,40,222,116,106,6627.3
84,41,120,60,60,4770.2
84,42,15,5,10,523.5
84,43,30,15,15,721.5
84,44,21,11,10,681.6
84,47,16,7,9,420.2
84,49,17,7,10,647.4
84,50,10,6,4,251
84,52,4,3,1,0
84,53,5,3,2,271
84,59,5,3,2,299
84,68,48,26,22,1334.7
84,87,4,1,3,0
84,88,1,1,0,0
84,100,2,1,1,0
84,104,7,3,4,174.3
84,105,2,2,0,0
84,106,20,11,9,790.7
84,107,7,3,4,0
84,108,5,3,2,0
84,109,11,6,5,313.5
84,112,1,0,1,0
84,113,403,214,189,13838.5
84,114,5,3,2,0
85,28,5,3,2,137
85,29,188,102,86,8129.700000000001
85,30,43,23,20,1718.6
85,31,69,36,33,2290.7
85,32,3,1,2,0
85,33,5,2,3,0
85,34,7,5,2,240.8
85,37,37,17,20,1332.4
85,38,15,10,5,319.2
85,39,23,13,10,876.2
85,40,12,6,6,384
85,41,79,48,31,2968.7
85,42,43,22,21,1273.7
85,43,11,8,3,212.8
85,44,9,6,3,186
85,45,7,5,2,0
85,47,18,11,7,589.2
85,52,2,1,1,0
85,62,6,5,1,214.8
85,64,9,5,4,312.3
85,65,3,1,2,0
85,72,1,1,0,0
85,78,1,1,0,0
85,81,16,6,10,736
85,87,30,16,14,1187.4
85,88,90,47,43,3898.8
85,94,2,1,1,0
85,95,27,15,12,1069
85,96,60,34,26,2363.5
85,105,11,6,5,349
85,107,27,16,11,1173
85,108,1,1,0,0
85,109,11,8,3,340.9
85,110,2,1,1,0
85,114,1,1,0,0
85,116,2,1,1,0
85,125,9,5,4,166
86,28,7,3,4,265.3
86,29,167,86,81,6247
86,30,192,95,97,5876.400000000001
86,31,896,488,408,27207.199999999997
86,32,52,23,29,1911.5
86,33,4,3,1,0
86,34,15,10,5,386
86,36,9,4,5,255
86,37,36,19,17,1364.4
86,38,16,7,9,504.3
86,39,6,3,3,187.8
86,40,15,10,5,483
86,41,21,9,12,747.6
86,42,8,5,3,166.8
86,43,22,11,11,913.1
86,44,8,4,4,280
86,45,9,5,4,0
86,46,35,20,15,1376
86,55,1,1,0,0
86,56,3,2,1,0
86,60,2,1,1,0
86,61,4,3,1,0
86,80,6,3,3,0
86,81,2,1,1,0
86,83,13,7,6,528.3
86,84,9,3,6,0
86,86,139,67,72,5811.3
86,87,116,57,59,5169.4
86,88,52,24,28,2235
86,89,31,17,14,1078.8
86,90,5,4,1,269
86,91,10,6,4,336
86,92,60,33,27,2660.6
86,93,16,9,7,830.4
86,94,11,6,5,366.3
86,96,16,9,7,667.7
86,98,1,0,1,0
86,109,1,1,0,0
86,117,5,2,3,190
86,125,9,5,4,329
87,28,5,3,2,259
87,29,127,64,63,4339.1
87,30,1504,758,746,52966.9
87,31,665,322,343,24040.899999999998
87,33,2,2,0,0
87,34,2,2,0,0
87,35,12,5,7,340
87,37,13,4,9,636.3
87,38,27,13,14,1000.2
87,39,44,22,22,2046.4
87,40,20,10,10,875
87,41,23,12,11,815.1
87,42,34,14,20,921.4000000000001
87,43,48,25,23,1533.4
87,47,118,61,57,5285.3
87,53,18,8,10,418.8
87,54,7,5,2,110
87,55,25,11,14,865
87,56,2,1,1,0
87,59,22,11,11,846.3
87,80,22,13,9,824.4
87,84,1,0,1,0
87,85,63,34,29,2393.7
87,92,9,4,5,423.9
87,93,273,136,137,11211.4
87,94,138,71,67,5193.1
87,95,75,40,35,3106.5
87,117,14,6,8,791
87,122,1,1,0,0
87,123,3,1,2,0
87,124,3,1,2,0
87,125,9,6,3,186
88,28,11,6,5,573.3
88,29,661,330,331,23096.9
88,30,3005,1460,1545,119612.5
88,31,725,343,382,33320.2
88,34,19,8,11,779.4
88,35,136,69,67,5236
88,36,148,76,72,5569.3
88,37,46,25,21,1785.6
88,39,21,11,10,739.5
88,40,12,5,7,67
88,41,25,10,15,1024.7
88,42,72,37,35,2203.6000000000004
88,43,21,12,9,652
88,44,10,3,7,365
88,46,76,39,37,2476.7
88,47,248,113,135,9453.8
88,48,113,57,56,4284.3
88,50,7,4,3,224
88,53,8,4,4,306
88,54,16,7,9,471.8
88,55,1,0,1,0
88,57,3,2,1,0
88,58,26,12,14,772.2
88,94,7,3,4,419.3
88,95,1,0,1,0
88,118,1,1,0,0
88,122,4,2,2,0
89,28,10,6,4,460
89,29,1029,513,516,36766.8
89,30,936,486,450,33600.2
89,31,30,17,13,1229.2
89,32,648,338,310,24531.3
89,33,763,381,382,29337
89,34,1426,688,738,58432.7
89,35,778,396,382,27362
89,36,20,13,7,632.8
89,37,20,12,8,873.5
89,38,8,5,3,382.4
89,39,35,19,16,1114.8
89,40,318,165,153,11003.5
89,41,20,10,10,677.3
89,42,78,44,34,3397.1000000000004
89,43,18,8,10,487.5
89,44,18,10,8,626.7
89,45,12,6,6,250
89,46,1,0,1,0
89,47,5,2,3,118
89,48,27,14,13,1071.9
89,49,9,6,3,257.4
89,50,5,3,2,142
89,51,4,3,1,0
89,52,31,19,12,1156.9
89,53,122,60,62,4118.4
89,54,27,15,12,790
89,55,9,4,5,359.2
89,56,301,155,146,9609.400000000001
89,57,165,88,77,6853
89,74,21,14,7,706.3
89,77,2,1,1,0
89,78,14,9,5,683.2
89,79,40,23,17,1785.3
89,80,19,10,9,566.8
90,29,82,46,36,3564.4
90,32,195,88,107,4738.5
90,33,190,105,85,6605.2
90,34,194,98,96,6822.9
90,35,686,357,329,19362.6
90,36,2,1,1,0
90,38,13,5,8,243.9
90,39,77,46,31,3588.6
90,40,198,100,98,4757.1
90,41,326,169,157,11531.4
90,42,284,138,146,10103
90,43,1,1,0,0
90,44,4,2,2,0
90,46,1,1,0,0
90,48,10,5,5,465
90,50,5,3,2,92
90,51,2,1,1,0
90,52,10,5,5,427
90,54,13,9,4,386.1
90,55,5,3,2,291
90,56,83,55,28,3076.5
90,57,193,104,89,8649.3
90,58,266,128,138,10835.4
90,61,9,7,2,434.7
90,62,10,6,4,327
90,63,8,3,5,420.8
90,73,1,1,0,0
90,75,12,5,7,646.8
90,76,11,7,4,520.3
90,122,41,23,18,1525.2
90,123,2,1,1,0
91,29,42,16,26,1520.4
91,30,24,13,11,1142.4
91,32,23,11,12,1002.8
91,33,1198,626,572,40566.899999999994
91,35,2,0,2,0
91,36,46,22,24,1718.1
91,37,263,142,121,8813.7
91,38,8,4,4,376.8
91,39,12,6,6,521
91,41,97,55,42,3273.9
91,42,24,13,11,581.4
91,43,25,14,11,826.7
91,44,27,15,12,980.1
91,46,4,3,1,0
91,47,5,1,4,0
91,48,13,5,8,441.3
91,50,5,3,2,264
91,52,13,4,9,267
91,53,5,3,2,146
91,54,9,6,3,168
91,56,23,12,11,515.5
91,57,25,11,14,970.2
91,58,1605,758,847,65609.3
91,59,23,14,9,769
91,60,37,21,16,1377.9
91,61,6,3,3,0
91,62,443,226,217,17979.7
91,63,8,4,4,0
91,66,3,2,1,0
91,67,2,1,1,0
91,71,1,1,0,0
91,72,16,7,9,217
91,73,1,0,1,0
91,76,30,16,14,1282.4
91,77,15,9,6,740.6
91,82,5,2,3,112
91,121,2,2,0,0
91,122,160,80,80,6994.3
91,123,98,48,50,4063.8
92,30,1331,660,671,51600.3
92,31,6076,3087,2989,214308.9
92,32,8723,4273,4450,345789.3
92,33,5434,2712,2722,198244.8
92,34,160,80,80,5657.200000000001
92,35,1201,569,632,42913.9
92,36,621,321,300,21671.3
92,37,1908,986,922,68713.9
92,38,308,149,159,11828
92,44,164,72,92,5506.1
92,45,8,2,6,154.7
92,46,42,24,18,1557.5
92,47,42,21,21,1576.2
92,49,3,2,1,0
92,50,43,21,22,1410.4
92,51,14,6,8,484.4
92,52,3,2,1,0
92,54,4,2,2,0
92,56,14,6,8,605.5
92,57,68,40,28,2831.5
92,58,69,42,27,2618.2
92,59,20,12,8,644
92,62,13,6,7,425.7
92,64,98,52,46,4166.8
92,65,4,3,1,0
92,67,1,1,0,0
92,69,32,15,17,1308.8
92,70,8,5,3,248
92,71,224,104,120,9268.5
92,72,25,15,10,1225
92,77,15,7,8,679
92,122,142,72,70,5266
92,125,2,1,1,0
93,28,75,28,47,2327.2
93,29,2357,1177,1180,82901.40000000001
93,30,592,290,302,25467.2
93,31,2309,1136,1173,86673.3
93,32,931,499,432,35108.4
93,33,6114,2999,3115,237236.69999999998
93,34,639,334,305,23847.3
93,35,20,11,9,982.5
93,38,966,497,469,35257.8
93,39,2343,1202,1141,81569.20000000001
93,40,1141,538,603,44413.6
93,41,14,6,8,686
93,45,10,5,5,352
93,46,6,3,3,0
93,47,191,97,94,6137.2
93,48,13,7,6,473
93,49,20,12,8,783.6
93,50,137,57,80,5038
93,51,172,91,81,6930.1
93,52,15,11,4,330.9
93,53,7,5,2,367.2
93,54,16,7,9,339.1
93,57,7,4,3,250.2
93,58,31,17,14,1073.1
93,59,89,49,40,3471
93,64,11,7,4,465.3
93,66,11,4,7,426.8
93,67,27,11,16,1234
93,72,62,29,33,2766.3
93,73,14,6,8,805.2
93,74,7,3,4,298.2
93,122,27,15,12,1102.5
93,124,8,4,4,280.8
94,29,904,465,439,28999.2
94,32,149,73,76,6406.700000000001
94,33,14431,7060,7371,622411.3
94,34,2829,1442,1387,102598.9
94,35,25,12,13,942.9
94,36,18,11,7,696.8
94,38,1,1,0,0
94,39,1778,913,865,60132.6
94,40,3370,1618,1752,138309.7
94,41,601,320,281,21587
94,42,15,7,8,469.5
94,43,25,12,13,943.8
94,44,50,27,23,1969.4
94,46,2,1,1,0
94,47,3,1,2,0
94,48,21,10,11,838.5
94,52,26,17,9,620.8
94,53,4,2,2,0
94,54,20,13,7,267.4
94,55,5,4,1,115
94,57,11,6,5,383.9
94,58,7,5,2,310.1
94,60,7,5,2,217
94,61,1,1,0,0
94,121,5,3,2,255
94,124,3,2,1,0
95,31,35,26,9,1449
95,32,570,295,275,22458
95,33,1719,868,851,65505.5
95,34,3652,1803,1849,137874.80000000002
95,35,1725,885,840,50937.2
95,36,1588,805,783,52546.9
95,37,156,85,71,5512.7
95,38,59,26,33,2326.5
95,39,13,6,7,631.8
95,40,18,9,9,891
95,41,106,57,49,3401.6
95,42,153,78,75,4853.2
95,43,53,26,27,1773.2
95,45,10,4,6,339
95,46,3,1,2,0
95,47,2,1,1,0
95,49,21,11,10,863.3
95,50,8,6,2,211.2
95,52,11,6,5,420.2
95,54,17,9,8,750.8
95,55,4,1,3,0
95,57,7,4,3,270
95,58,11,5,6,502.7
95,59,4,2,2,0
95,61,2,1,1,0
95,106,2,1,1,0
95,113,2,1,1,0
95,121,20,12,8,587.2
95,124,19,12,7,929.4
96,31,1777,894,883,59765.1
96,32,3747,1876,1871,118535.9
96,33,3944,1952,1992,137205.3
96,34,1418,669,749,58567.4
96,35,365,193,172,17716.5
96,36,5,4,1,0
96,38,39,25,14,1499.2
96,39,30,19,11,1167.2
96,40,26,11,15,908.6
96,41,47,32,15,1306.8
96,42,68,40,28,2359.3
96,44,60,35,25,2116.8
96,45,6,4,2,0
96,46,15,8,7,432.3
96,47,4,2,2,0
96,48,9,5,4,277.2
96,49,36,18,18,1411.2
96,51,4,2,2,0
96,53,3,2,1,0
96,54,5,2,3,172
96,57,12,7,5,360
96,60,3,2,1,0
96,61,1,0,1,0
96,96,2,0,2,0
96,106,12,9,3,182.4
96,112,17,9,8,780.3
96,115,6,4,2,216
96,116,3,1,2,0
96,120,73,36,37,3555.6
96,123,10,7,3,354
96,124,23,12,11,1035.3
97,30,62,34,28,2005.6000000000001
97,31,259,143,116,9476.8
97,32,218,113,105,8844
97,33,79,39,40,3000.4
97,34,2784,1378,1406,98537.8
97,35,741,379,362,28457.3
97,36,283,136,147,11400.2
97,37,847,429,418,28122.2
97,39,34,15,19,1580
97,40,37,19,18,1309.5
97,41,20,10,10,598
97,42,50,27,23,1767
97,44,31,18,13,1009.5
97,45,17,8,9,463
97,46,7,4,3,399
97,47,36,25,11,1054.8
97,48,118,61,57,4400
97,50,15,7,8,442.5
97,51,5,2,3,333
97,52,5,2,3,319
97,54,16,8,8,516.8
97,84,3,2,1,0
97,90,1,1,0,0
97,94,9,5,4,403.2
97,105,3,2,1,0
97,106,3,1,2,0
97,107,55,31,24,1960
97,108,3,2,1,0
97,110,1,1,0,0
97,111,29,16,13,1045
97,112,55,23,32,2394.3
97,113,8,4,4,262.2
97,114,5,2,3,0
97,115,34,19,15,1337
97,116,25,14,11,1330.6
97,117,36,17,19,1664.1
97,118,23,12,11,941.5
97,119,14,6,8,672
97,120,24,12,12,883.7
97,123,10,6,4,460
98,30,59,33,26,2128
98,31,57,32,25,2404.7
98,32,49,26,23,1905.6
98,33,32,17,15,1075.2
98,34,12,7,5,328.8
98,36,32,19,13,1368
98,37,558,284,274,21446.7
98,38,158,71,87,5656.4
98,40,6,4,2,292
98,42,75,35,40,2050
98,45,8,5,3,193.9
98,46,5,3,2,190
98,47,44,21,23,1681.2
98,48,21,10,11,972.4
98,49,26,12,14,352.5
98,51,2,1,1,0
98,53,8,5,3,328
98,54,16,11,5,295.4
98,57,19,10,9,847.8
98,83,12,6,6,344
98,84,4,3,1,0
98,94,15,10,5,649.5
98,97,5,3,2,145
98,98,1,1,0,0
98,105,2,1,1,0
98,107,10,6,4,291.2
98,115,75,35,40,3050.3
98,119,18,10,8,1114.5
98,120,1,0,1,0
98,122,10,5,5,486
99,31,17,9,8,880.6
99,32,42,25,17,1442
99,33,76,38,38,3857.2
99,34,6,3,3,0
99,35,1,1,0,0
99,38,225,117,108,8762.5
99,39,114,50,64,4083
99,40,18,9,9,721.8
99,47,13,6,7,430.3
99,48,3,1,2,0
99,49,19,9,10,744
99,50,15,9,6,450.8
99,51,4,2,2,0
99,52,10,3,7,119
99,53,15,7,8,568.5
99,54,47,26,21,1599
99,57,10,6,4,333
99,73,5,1,4,169
99,87,1,1,0,0
99,88,2,2,0,0
99,89,4,3,1,0
99,93,5,3,2,0
99,105,11,7,4,401.4
99,107,5,2,3,123
99,110,1,1,0,0
99,114,46,27,19,2242.7
99,115,73,44,29,2996.1000000000004
99,118,14,8,6,751.8
99,121,2,1,1,0
99,122,24,11,13,899
100,30,13,7,6,718.9
100,31,171,80,91,7312.699999999999
100,32,285,142,143,10994.5
100,33,176,91,85,6605.7
100,34,34,17,17,792.3
100,35,20,11,9,848.5
100,36,1,1,0,0
100,38,1,1,0,0
100,39,33,18,15,897
100,40,166,91,75,6463.8
100,41,137,73,64,4699.2
100,42,112,55,57,3466
100,44,1,1,0,0
100,45,16,10,6,401.8
100,50,5,4,1,0
100,51,7,4,3,265.3
100,53,33,15,18,1045.1999999999998
100,54,6,3,3,160.8
100,56,8,6,2,304
100,57,7,5,2,144
100,61,14,6,8,567
100,71,1,1,0,0
100,87,13,9,4,390
100,88,2,2,0,0
100,93,6,4,2,124.2
100,96,3,2,1,0
100,97,1,1,0,0
100,103,7,3,4,0
100,104,5,3,2,185
100,105,120,61,59,4443.5
100,106,8,4,4,326.4
100,107,15,8,7,592
100,110,5,4,1,221
100,111,3,2,1,0
100,112,5,2,3,255
100,113,35,11,24,1560.1999999999998
100,118,8,4,4,346.4
100,120,17,8,9,406.4
101,31,45,26,19,1539
101,32,75,39,36,3792.2
101,33,405,210,195,15796.5
101,34,123,62,61,5106.1
101,35,73,43,30,3221
101,36,61,35,26,2348.5
101,37,8,6,2,340.8
101,38,10,5,5,407
101,39,11,6,5,426.8
101,41,45,18,27,1496.7
101,42,689,336,353,25794.5
101,43,88,47,41,2786.1
101,45,28,14,14,810
101,46,16,8,8,720
101,47,6,3,3,271.2
101,51,4,2,2,0
101,56,12,5,7,351.6
101,57,8,5,3,129
101,60,1,1,0,0
101,61,51,31,20,2249.4
101,62,4,3,1,0
101,66,7,3,4,314.3
101,70,9,5,4,440.1
101,71,25,10,15,939.2
101,78,2,0,2,0
101,86,8,3,5,280.8
101,87,11,6,5,360.8
101,88,27,18,9,910.6
101,89,8,5,3,145.8
101,90,4,3,1,0
101,93,17,9,8,788.7
101,94,20,6,14,754
101,101,6,3,3,142
101,102,12,7,5,457
101,103,13,7,6,506.7
101,104,80,41,39,3343.3
101,105,629,313,316,26357.9
101,106,5,2,3,98
101,107,7,3,4,143
101,108,22,12,10,963.1
101,109,11,5,6,303
101,110,8,6,2,278
101,111,36,15,21,1380
101,112,110,56,54,4098
101,120,12,6,6,174.4
102,33,17,7,10,754.8
102,34,116,62,54,4284
102,35,34,20,14,1322.9
102,36,63,35,28,2352.9
102,38,5,3,2,128
102,41,187,90,97,5025.9
102,42,1813,912,901,68912.8
102,43,173,87,86,6213.3
102,44,20,11,9,516.8
102,46,5,3,2,101
102,49,4,3,1,0
102,50,1,1,0,0
102,52,13,6,7,435.5
102,53,7,3,4,252
102,57,5,4,1,178
102,63,1,1,0,0
102,86,19,11,8,851.2
102,89,145,72,73,5191
102,90,236,106,130,10409.5
102,91,61,35,26,3201.2
102,92,3,2,1,0
102,93,33,14,19,977.4
102,94,19,8,11,631.5
102,95,16,9,7,360
102,96,30,13,17,1194
102,100,9,4,5,405
102,101,124,59,65,5377
102,102,18,10,8,838.5999999999999
102,103,65,35,30,2761
102,104,6,4,2,211.2
102,105,133,61,72,6374.099999999999
102,106,52,29,23,2065.7
102,109,5,3,2,209
102,110,7,4,3,93
102,111,55,28,27,2076.2
102,112,667,310,357,27665.600000000002
102,113,6,3,3,393
102,114,16,9,7,751.2
102,115,2,1,1,0
102,116,8,5,3,0
102,117,20,11,9,873
102,118,8,5,3,0
102,120,20,13,7,662
103,34,63,32,31,2800.3
103,35,3,1,2,0
103,36,107,56,51,5411.3
103,37,4,2,2,0
103,39,68,37,31,1792.4
103,40,37,18,19,1208.8
103,41,8,3,5,284.8
103,42,14,8,6,237
103,43,74,33,41,2684.2
103,44,18,10,8,613.1
103,45,39,24,15,1736.1
103,46,4,2,2,0
103,48,1,0,1,0
103,49,20,7,13,626.4
103,51,11,5,6,338.8
103,52,1,1,0,0
103,53,8,5,3,172.2
103,54,6,4,2,256.2
103,57,2,1,1,0
103,59,8,5,3,212.8
103,68,6,3,3,358.8
103,69,21,15,6,835.8
103,86,4,3,1,0
103,87,18,10,8,788.9000000000001
103,89,4,1,3,0
103,90,135,66,69,5555.1
103,91,28,16,12,882.4000000000001
103,92,32,15,17,1177
103,93,60,36,24,2037.6
103,94,4,2,2,0
103,95,16,9,7,634.4
103,96,44,19,25,1936.1
103,97,4,3,1,0
103,101,17,10,7,739.5
103,102,2,1,1,0
103,114,14,8,6,512.4
103,115,23,12,11,895.6
103,116,3,3,0,0
103,117,3,2,1,0
103,118,18,9,9,525
103,120,134,77,57,5497.4
104,34,59,24,35,2273.6
104,35,49,29,20,2106
104,36,51,25,26,1663.9
104,37,244,113,131,8443.9
104,38,8,3,5,213
104,39,28,15,13,813.4
104,40,3,2,1,0
104,41,2,1,1,0
104,42,1,1,0,0
104,43,14,8,6,282
104,44,16,7,9,493.6
104,45,10,4,6,316
104,47,51,31,20,1716.4
104,48,4,2,2,0
104,49,5,3,2,82
104,50,18,8,10,649.4
104,51,4,1,3,0
104,55,2,1,1,0
104,61,21,13,8,897.4000000000001
104,63,2,1,1,0
104,68,24,12,12,1062.5
104,76,10,5,5,471
104,77,1,1,0,0
104,95,2,2,0,0
104,96,15,8,7,490.1
104,97,47,25,22,2188.8
104,98,3,1,2,0
104,100,6,3,3,205.2
104,106,3,2,1,0
104,117,44,23,21,2019.4
104,118,296,138,158,10903.4
104,119,293,139,154,11614.5
104,120,17,10,7,919.7
105,35,108,51,57,4556.4
105,36,109,59,50,4192.5
105,37,4177,2072,2105,168198.2
105,38,1122,557,565,45768.1
105,41,10,6,4,376
105,43,39,24,15,1392.4
105,44,2,2,0,0
105,49,40,21,19,1230.1999999999998
105,50,2,1,1,0
105,51,1,0,1,0
105,53,4,1,3,0
105,59,61,33,28,2291.4
105,60,2,1,1,0
105,62,2,1,1,0
105,66,6,3,3,331.2
105,73,11,5,6,301.2
105,74,5,3,2,213
105,97,37,17,20,1428.2
105,98,36,16,20,1598.4
105,99,29,16,13,1145.5
105,100,20,12,8,964
105,101,46,25,21,1794.5
105,102,9,4,5,332.1
105,103,11,6,5,369.6
105,104,7,2,5,0
105,105,7,4,3,0
105,106,10,5,5,226.8
105,107,17,10,7,747.6
105,117,4,2,2,0
105,118,91,42,49,3884.3
105,119,31,16,15,1446
105,126,6,1,5,115.2
106,36,1,1,0,0
106,37,300,160,140,11893.3
106,38,1167,581,586,40241.399999999994
106,39,37,18,19,1217.3
106,40,18,8,10,498.6
106,43,4,1,3,0
106,44,2,1,1,0
106,46,8,3,5,372.8
106,47,3,2,1,0
106,49,6,4,2,0
106,50,2,2,0,0
106,51,8,6,2,299.2
106,52,98,56,42,3301.2000000000003
106,53,151,72,79,6123.4
106,56,18,12,6,718.3
106,59,10,6,4,300
106,60,2,2,0,0
106,61,4,2,2,0
106,63,16,7,9,617.6
106,71,1,1,0,0
106,72,1,0,1,0
106,73,3,2,1,0
106,74,2,2,0,0
106,79,5,3,2,299
106,80,4,3,1,0
106,83,1,1,0,0
106,84,8,3,5,146
106,99,2,1,1,0
106,100,24,14,10,1514.4
106,101,5,3,2,346
106,102,4,2,2,0
106,103,78,36,42,3447.6
106,104,79,39,40,3659.7999999999997
106,105,31,14,17,1131.5
106,106,4,3,1,0
106,107,30,15,15,1119
106,108,15,8,7,544.6
106,109,2,1,1,0
106,110,20,13,7,635
106,112,21,8,13,721
106,117,8,3,5,196.2
106,118,59,32,27,2485.4
106,119,6,3,3,199.8
106,125,4,2,2,0
107,37,19,9,10,687.8
107,38,108,58,50,3626.1
107,39,330,162,168,8712.3
107,40,29,17,12,1048.6
107,42,5,2,3,131
107,44,6,4,2,288
107,45,8,4,4,228.2
107,46,2,1,1,0
107,47,6,2,4,0
107,48,2,1,1,0
107,51,1,1,0,0
107,55,14,9,5,680.4
107,58,19,9,10,820.8
107,61,2,1,1,0
107,62,12,5,7,433.2
107,63,90,45,45,3297.4
107,64,16,8,8,441.6
107,71,15,8,7,733.5
107,72,32,16,16,1260.5
107,79,14,8,6,259.2
107,80,26,13,13,979.8
107,83,6,4,2,307.2
107,99,13,7,6,0
107,102,6,4,2,202.8
107,103,8,3,5,240
107,104,15,9,6,328.9
107,106,1,1,0,0
107,107,171,81,90,7438.3
107,108,19,11,8,856.6
107,109,3,2,1,0
107,110,11,7,4,109.8
107,111,77,40,37,2742.8
107,112,55,30,25,2356.3
107,114,5,2,3,279
107,117,2,1,1,0
107,118,10,6,4,353
107,121,7,2,5,180
107,122,3,2,1,0
107,123,1,0,1,0
107,124,5,4,1,192
107,125,5,2,3,0
107,126,3,2,1,0
108,38,86,40,46,3838.2
108,39,83,46,37,3088.3
108,41,19,11,8,692
108,42,227,122,105,8361.5
108,43,13,4,9,495.6
108,45,19,9,10,412.70000000000005
108,46,8,6,2,154
108,47,8,3,5,312
108,48,11,6,5,438.9
108,49,4,3,1,0
108,50,4,2,2,0
108,51,10,6,4,386.4
108,52,18,11,7,656.2
108,53,16,6,10,686.4
108,57,45,24,21,1924
108,58,15,8,7,597
108,59,9,5,4,404.1
108,60,17,7,10,569.5
108,61,23,11,12,550
108,62,3,2,1,0
108,63,6,3,3,0
108,64,4,3,1,0
108,70,19,11,8,911.7
108,71,26,12,14,772.8
108,72,1,1,0,0
108,75,1,1,0,0
108,98,3,1,2,0
108,99,4,2,2,0
108,106,1,0,1,0
108,107,10,4,6,387.2
108,110,2,2,0,0
108,111,25,12,13,592.5
108,112,7,3,4,0
108,113,3,1,2,0
108,114,40,21,19,1224.9
108,115,18,10,8,576
108,116,19,11,8,692.1
108,117,9,4,5,226
108,121,12,4,8,316.8
108,123,7,3,4,261.8
109,38,623,319,304,22232
109,39,131,72,59,4351.3
109,40,27,13,14,937.2
109,41,54,25,29,2083.7
109,42,61,35,26,2423.4
109,43,7,5,2,137.2
109,45,10,5,5,198.8
109,46,5,2,3,174
109,49,10,7,3,210.6
109,50,3,2,1,0
109,51,4,2,2,0
109,52,26,12,14,792.6
109,53,28,15,13,1035.6
109,57,2,1,1,0
109,59,1,1,0,0
109,60,2,1,1,0
109,61,6,3,3,301.8
109,62,2,1,1,0
109,63,8,4,4,236
109,68,1,1,0,0
109,69,10,6,4,271.2
109,70,8,7,1,304.8
109,75,6,3,3,189
109,98,4,3,1,0
109,99,5,2,3,0
109,107,33,17,16,1195.8
109,108,2,2,0,0
109,113,36,16,20,1393.4
109,114,2,1,1,0
109,121,12,6,6,678
109,122,17,9,8,646
109,123,3,1,2,0
109,126,9,6,3,211
110,38,70,35,35,2626.9
110,39,17,6,11,345
110,40,197,112,85,7038.4
110,41,94,50,44,3479.4
110,42,1104,553,551,31115.700000000004
110,43,121,68,53,4029.3
110,44,9,4,5,231
110,45,108,51,57,3697.8
110,47,10,7,3,467
110,48,15,5,10,452.4
110,49,7,3,4,220
110,53,77,43,34,2806.2
110,54,22,11,11,830.6
110,55,46,30,16,1436.2
110,56,9,5,4,366.3
110,57,5,3,2,0
110,58,2,1,1,0
110,63,4,3,1,0
110,64,25,13,12,841.5
110,65,9,6,3,153
110,68,3,2,1,0
110,76,5,1,4,258
110,87,5,2,3,146
110,97,18,11,7,588.2
110,104,15,9,6,486.2
110,105,10,7,3,255.6
110,106,10,7,3,306
110,107,2,2,0,0
110,112,5,2,3,225
110,113,6,5,1,0
110,115,3,2,1,0
110,118,1,1,0,0
110,121,7,5,2,282.8
110,122,3,1,2,0
111,40,145,76,69,5458.1
111,41,2119,1082,1037,78606.7
111,42,2345,1189,1156,81672.59999999999
111,43,292,147,145,9672.900000000001
111,44,2,1,1,0
111,45,15,10,5,852
111,47,7,2,5,157
111,49,1,0,1,0
111,51,6,2,4,196.2
111,52,7,4,3,343.7
111,53,23,12,11,637.1
111,54,6,3,3,243
111,55,15,8,7,386.1
111,58,1,1,0,0
111,64,10,5,5,401.4
111,65,313,145,168,12128.9
111,66,277,132,145,12102.2
111,67,2,1,1,0
111,68,4,3,1,0
111,87,4,2,2,0
111,88,23,15,8,599
111,90,4,1,3,0
111,96,7,3,4,203.7
111,97,9,6,3,256.8
111,101,1,1,0,0
111,103,2,1,1,0
111,104,22,14,8,881.7
111,105,5,3,2,104
111,106,4,2,2,0
111,112,1,1,0,0
112,41,1408,708,700,62966.2
112,42,4353,2157,2196,178353.49999999997
112,43,588,300,288,22374
112,45,40,23,17,1347.8
112,46,12,6,6,371.2
112,47,93,49,44,3156.6
112,48,24,12,12,731.4
112,51,11,6,5,459.9
112,52,6,4,2,238.2
112,53,4,1,3,0
112,54,45,21,24,1530.3000000000002
112,55,24,11,13,1016.4000000000001
112,56,3,1,2,0
112,58,50,28,22,1721.5
112,64,4,3,1,0
112,65,53,30,23,1651.5
112,66,93,52,41,3224.1000000000004
112,67,26,13,13,1087.8
112,68,7,2,5,256.9
112,74,1,1,0,0
112,75,1,0,1,0
112,76,10,4,6,358
112,77,4,2,2,0
112,82,5,2,3,84
112,86,3,0,3,0
112,87,2,1,1,0
112,88,9,6,3,173
112,96,7,3,4,217
112,97,12,4,8,457.2
112,101,2,1,1,0
112,103,4,1,3,0
112,104,10,5,5,370.4
112,105,3,2,1,0
112,106,18,7,11,817.8
112,111,4,3,1,0
112,115,28,18,10,906.1
112,116,6,6,0,265.8
112,118,1,1,0,0
112,124,5,2,3,206
112,125,4,2,2,0
113,41,14,7,7,634.2
113,42,268,136,132,9941.400000000001
113,43,968,490,478,34312.9
113,44,77,36,41,2672.3
113,45,136,66,70,5444.799999999999
113,46,222,107,115,7384.2
113,47,91,48,43,3973
113,48,86,43,43,3444.2
113,49,30,15,15,1275
113,50,77,42,35,2495.4
113,51,277,140,137,10556.400000000001
113,52,42,23,19,1380
113,54,7,4,3,0
113,55,2,1,1,0
113,57,24,15,9,860.2
113,58,20,11,9,450.70000000000005
113,59,7,3,4,170.8
113,62,10,6,4,364
113,65,41,21,20,1428
113,66,25,15,10,938
113,68,28,16,12,1136.8
113,69,4,2,2,0
113,75,46,19,27,1787.6
113,76,60,31,29,2583.2
113,77,38,16,22,1729
113,80,92,48,44,4057.2
113,81,11,6,5,327.8
113,84,11,6,5,521.4
113,85,18,9,9,679.5
113,86,31,15,16,1090.8
113,87,5,2,3,227
113,88,29,17,12,934.2
113,96,13,6,7,638.4
113,97,31,14,17,1061
113,101,5,2,3,271
113,102,10,7,3,638.1
113,103,10,5,5,389.9
113,104,16,9,7,808.4
113,105,84,41,43,3466.8999999999996
113,106,83,40,43,3467.8
113,111,5,3,2,305
113,112,30,13,17,1230
113,114,19,12,7,616.5
113,115,40,25,15,1971.9999999999998
113,116,6,3,3,205.2
113,125,1,0,1,0
114,41,6,4,2,388.8
114,42,92,43,49,3484.5
114,43,1531,759,772,51928.399999999994
114,44,329,168,161,13069.400000000001
114,45,362,187,175,14106.400000000001
114,46,607,303,304,21509.4
114,47,179,98,81,6812.5
114,48,163,84,79,5281.8
114,49,166,89,77,6171.7
114,50,336,168,168,10124.7
114,51,1369,675,694,54557.5
114,52,63,31,32,2490.5
114,53,82,44,38,2583.6000000000004
114,54,113,62,51,3616.2
114,55,1,0,1,0
114,56,91,43,48,3336
114,57,24,11,13,726
114,58,1,1,0,0
114,62,32,18,14,1484.6
114,69,4,3,1,0
114,70,8,4,4,354
114,72,17,9,8,491.3
114,73,19,9,10,619.4
114,77,6,4,2,225
114,79,156,81,75,6825.200000000001
114,80,364,189,175,13204
114,81,10,3,7,225
114,82,9,5,4,558.9
114,85,9,5,4,324.1
114,86,1,1,0,0
114,87,22,11,11,1060
114,88,133,65,68,6116.200000000001
114,89,22,13,9,944.8
114,90,20,8,12,748
114,91,5,2,3,105
114,96,19,11,8,394.8
114,97,175,92,83,8288.7
114,100,20,11,9,872.1
114,101,163,87,76,6876.7
114,102,190,96,94,8046.8
114,103,36,20,16,1237.8
114,104,12,6,6,317.8
114,105,35,14,21,1252.7
114,106,1,0,1,0
114,110,5,3,2,0
114,111,14,8,6,695.1
114,113,26,15,11,866.2
114,114,55,24,31,2512.8999999999996
115,43,548,277,271,21551.8
115,44,2100,1024,1076,80835
115,45,1171,586,585,40785.899999999994
115,46,414,195,219,17062.6
115,47,60,29,31,2270.8
115,48,122,60,62,5011.9
115,49,158,84,74,6363.4
115,50,288,147,141,11012.7
115,51,1128,575,553,35666.7
115,52,171,82,89,6521
115,53,88,46,42,2890
115,54,10,5,5,262
115,55,58,33,25,1977.6
115,56,41,21,20,1327.4
115,59,131,72,59,5536.7
115,60,1,1,0,0
115,61,4,3,1,0
115,62,21,10,11,778.2
115,69,16,7,9,562.8
115,71,3,2,1,0
115,72,25,16,9,718
115,78,39,20,19,1716
115,79,25,11,14,1150.2
115,87,15,8,7,574.2
115,88,6,3,3,0
115,89,19,9,10,750.5
115,90,23,10,13,1111.3
115,93,7,3,4,0
115,94,12,5,7,572.4
115,95,6,3,3,232.2
115,96,51,28,23,2303.3
115,97,59,32,27,2507.5
115,99,5,3,2,0
115,100,73,34,39,2798.4
115,101,551,266,285,25297.3
115,102,59,31,28,2498.4
115,103,53,26,27,2754.3
115,104,7,3,4,0
115,105,51,27,24,1747.4
115,106,9,6,3,372.6
115,111,8,6,2,183
115,112,21,10,11,1045.8
116,43,5,4,1,99
116,44,742,371,371,29852.6
116,45,1039,529,510,41018.4
116,46,2091,1043,1048,82112.79999999999
116,47,1826,916,910,68096.5
116,48,90,45,45,4011.1000000000004
116,49,627,317,310,18163.9
116,50,13,8,5,399.6
116,51,25,13,12,1095
116,52,43,23,20,2046.8000000000002
116,53,29,13,16,963.7
116,54,9,7,2,327.6
116,57,4,2,2,0
116,58,13,8,5,475.2
116,59,3,2,1,0
116,61,9,4,5,263.2
116,63,24,14,10,1088
116,78,6,4,2,280.8
116,79,1,0,1,0
116,80,1,1,0,0
116,98,5,4,1,0
116,99,29,13,16,1405.1
116,100,95,45,50,3532.1
116,103,50,29,21,1732
116,104,25,13,12,1139.7
116,111,10,4,6,670
117,46,513,280,233,21093.1
117,47,3646,1787,1859,147819.2
117,48,2548,1261,1287,101406.1
117,49,1270,639,631,43089.4
117,50,100,53,47,4028.9
117,51,15,6,9,518.4
117,52,1,1,0,0
117,53,4,1,3,0
117,54,26,14,12,930.9999999999999
117,55,51,29,22,1685
117,56,44,25,19,1496
117,57,2,1,1,0
117,58,1,0,1,0
117,59,5,3,2,245
117,60,11,5,6,371.7
117,61,55,31,24,2445
117,64,7,3,4,235.9
117,65,4,1,3,0
117,66,2,1,1,0
117,70,8,6,2,356
117,74,6,3,3,223.8
117,103,41,22,19,1841.1999999999998
117,104,45,22,23,2154.6
117,110,31,17,14,1159.8999999999999
117,111,10,6,4,470
117,112,40,19,21,1298.4
117,113,14,6,8,342
117,127,5,3,2,243
118,46,59,28,31,1747.6
118,47,2395,1204,1191,95421.79999999999
118,48,6194,3000,3194,265090.1
118,49,4048,1964,2084,161071.1
118,50,166,89,77,6630.5
118,51,270,132,138,9171.6
118,52,30,16,14,935.5
118,53,1,1,0,0
118,56,3,1,2,0
118,57,6,4,2,340.2
118,60,3,1,2,0
118,61,62,30,32,2701.8
118,62,13,7,6,597.9
118,64,4,2,2,0
118,65,8,3,5,379.2
118,66,2,1,1,0
118,67,4,2,2,0
118,72,4,2,2,0
118,73,1,1,0,0
118,102,1,1,0,0
118,103,29,13,16,1481.4
118,104,80,41,39,3654.5
118,105,112,57,55,3434.6
118,106,12,7,5,537.6
118,109,91,45,46,3749.8
118,110,226,118,108,9215.1
118,111,61,33,28,2506
118,127,38,20,18,1704
119,46,4,2,2,0
119,47,455,222,233,19599.6
119,48,1808,894,914,74604.3
119,49,1272,636,636,48793.3
119,50,1,0,1,0
119,51,152,80,72,5900.7
119,52,90,53,37,3395.6000000000004
119,53,100,53,47,4350.9
119,54,3,2,1,0
119,56,3,2,1,0
119,57,16,7,9,555.1
119,59,1,1,0,0
119,61,35,18,17,1408.6
119,62,13,9,4,562.9
119,63,43,24,19,1588.8000000000002
119,64,37,17,20,1218
119,66,14,7,7,448
119,73,50,29,21,1840
119,91,13,9,4,217.2
119,102,6,4,2,0
119,103,2,1,1,0
119,104,6,4,2,169.2
119,105,1134,521,613,49976.8
119,106,96,44,52,3785.6000000000004
119,108,15,10,5,504
119,109,63,33,30,2344.4
119,110,5,3,2,0
119,111,4,2,2,0
119,112,17,8,9,1033.6
119,127,93,44,49,3753.6
120,47,217,112,105,9411.4
120,48,379,190,189,14558.8
120,49,1035,531,504,41813.399999999994
120,50,1834,930,904,71085.4
120,51,55,28,27,2111.3
120,52,98,50,48,4021.3999999999996
120,53,120,64,56,4876.9
120,54,26,13,13,1098.6
120,55,8,5,3,0
120,56,12,7,5,411.3
120,59,56,33,23,2323.9
120,60,33,17,16,1412.1
120,61,23,13,10,1016.4
120,62,15,6,9,803.4
120,63,12,8,4,528
120,66,12,4,8,466.8
120,72,12,8,4,500.4
120,73,60,33,27,2009.6
120,78,2,1,1,0
120,81,1,1,0,0
120,82,8,5,3,460.8
120,90,29,16,13,1110.7
120,91,7,3,4,170.1
120,95,52,28,24,2194.4
120,96,12,3,9,363.6
120,102,15,5,10,374.2
120,104,33,15,18,1214.4
120,105,138,66,72,6317.6
120,106,174,85,89,7228.2
120,107,28,14,14,947.6
120,111,30,16,14,1048.5
120,112,155,76,79,6316.3
120,124,3,2,1,0
120,127,730,353,377,32134.3
121,47,168,90,78,6253.700000000001
121,48,121,61,60,4711.6
121,49,1213,604,609,43228.8
121,50,1572,777,795,62799.8
121,51,153,78,75,5434.2
121,52,72,42,30,3137.1000000000004
121,53,18,7,11,661.5
121,54,28,16,12,1014
121,55,75,33,42,3565.8
121,57,264,125,139,8840.4
121,58,34,17,17,1741.9
121,59,19,8,11,777.4
121,60,175,91,84,6263.3
121,61,7,4,3,357
121,62,7,5,2,0
121,63,16,8,8,299.6
121,64,3,2,1,0
121,65,8,4,4,224
121,66,73,29,44,2522.3999999999996
121,82,12,8,4,582.3
121,86,10,5,5,154
121,90,7,4,3,364.2
121,94,5,3,2,193
121,95,9,4,5,132
121,100,3,1,2,0
121,101,20,9,11,891.3
121,102,27,14,13,814.1
121,104,12,6,6,520.8
121,106,8,4,4,388.8
121,107,2,1,1,0
121,111,20,10,10,756
121,112,117,56,61,4632
121,123,11,5,6,320.8
121,127,1459,710,749,58803.4
122,48,1,1,0,0
122,49,366,189,177,13903.599999999999
122,50,167,87,80,7133.2
122,51,367,187,180,14176.6
122,52,23,13,10,986.1
122,53,85,44,41,3563.3999999999996
122,54,54,30,24,2093
122,55,107,56,51,4381.7
122,56,162,91,71,7071.3
122,57,181,91,90,7116.7
122,58,26,13,13,1129.4
122,59,9,5,4,306
122,62,32,23,9,1116.2
122,63,159,76,83,5625.4
122,64,495,239,256,20584.5
122,65,68,34,34,2218.2
122,66,46,24,22,1642.4
122,67,37,20,17,1347
122,81,6,3,3,0
122,82,17,9,8,697.2
122,86,19,10,9,661.2
122,87,7,3,4,438.9
122,89,6,5,1,351
122,90,72,39,33,3008.5
122,91,22,13,9,1122
122,92,13,9,4,440.8
122,95,7,3,4,298.2
122,96,1,1,0,0
122,100,2,1,1,0
122,101,3,2,1,0
122,102,26,12,14,750.8
122,103,20,9,11,715
122,111,7,2,5,279.3
122,112,108,52,56,5065.5
122,113,2,1,1,0
122,127,663,310,353,30998.100000000002
123,50,58,30,28,2269.5
123,51,182,91,91,7784.299999999999
123,52,119,59,60,5168.4
123,53,36,21,15,1334.1
123,54,64,36,28,2514.8
123,55,33,16,17,1225.5
123,56,845,415,430,32391.8
123,57,1231,576,655,56246.100000000006
123,58,104,55,49,4127.9
123,59,10,5,5,464
123,61,3,2,1,0
123,64,181,89,92,6406.3
123,65,4,2,2,0
123,67,17,11,6,830.5
123,68,28,11,17,1039.8
123,82,6,3,3,136
123,83,12,7,5,422.4
123,85,1,1,0,0
123,86,117,61,56,4958.3
123,87,66,33,33,2913.2
123,88,9,3,6,548.1
123,89,11,7,4,498.8
123,90,6,3,3,310.8
123,92,2,1,1,0
123,96,2,1,1,0
123,97,5,3,2,0
123,101,5,3,2,174
123,102,2,1,1,0
123,103,6,4,2,238.8
123,111,2,1,1,0
123,112,27,14,13,1208.7
123,120,4,3,1,0
123,121,1,1,0,0
123,122,8,5,3,347.2
123,127,363,183,180,14480.900000000001
124,52,244,118,126,10945.9
124,53,503,246,257,22016.9
124,54,25,15,10,1033.2
124,55,126,62,64,5303.4
124,56,98,45,53,4716.1
124,57,396,193,203,15080
124,58,139,71,68,5004.099999999999
124,59,6,2,4,280.8
124,62,18,5,13,303.7
124,63,28,13,15,942.5
124,64,39,22,17,1158.8
124,65,12,6,6,281
124,66,3,2,1,0
124,67,1,0,1,0
124,70,25,11,14,916.3
124,83,30,14,16,1089
124,84,45,22,23,1868.6999999999998
124,85,11,7,4,416
124,96,11,7,4,350.1
124,101,2,2,0,0
124,102,7,3,4,242.2
124,111,1,1,0,0
124,112,9,4,5,540.9
124,120,23,10,13,1021
124,121,2,1,1,0
124,122,5,3,2,236
124,126,2,2,0,0
124,127,31,14,17,920.7
125,52,34,16,18,1509.6
125,53,221,102,119,9180.8
125,54,134,66,68,5450.8
125,55,63,29,34,3292.5
125,56,18,9,9,809.2
125,57,4,3,1,0
125,58,10,4,6,353
125,59,140,67,73,5196.6
125,61,6,4,2,183
125,62,11,6,5,175.8
125,63,9,4,5,438.3
125,64,34,17,17,1058.4
125,66,11,7,4,350.7
125,67,21,8,13,846.3
125,68,2,1,1,0
125,71,83,47,36,3183.6
125,73,12,7,5,482.4
125,83,36,12,24,1443.4
125,84,104,55,49,3786.5
125,102,40,19,21,1953.6999999999998
125,112,30,14,16,1104.1
125,113,1,1,0,0
125,118,2,1,1,0
125,119,5,2,3,0
125,120,76,41,35,3075.3999999999996
125,127,1,0,1,0
126,53,3,2,1,0
126,54,132,66,66,5540.5
126,55,1,1,0,0
126,56,80,38,42,3533
126,58,2,1,1,0
126,59,67,33,34,2090.9
126,60,336,178,158,13179.2
126,61,54,28,26,2188
126,62,9,6,3,369.9
126,63,19,11,8,680.2
126,64,2,1,1,0
126,65,5,2,3,0
126,67,16,7,9,689.6
126,68,2,2,0,0
126,71,106,54,52,4096.8
126,72,85,43,42,3203
126,73,6,5,1,114
126,83,21,14,7,715.9
126,84,3,2,1,0
126,90,5,3,2,204
126,95,5,3,2,301
126,100,3,2,1,0
126,101,32,18,14,1094.2
126,102,103,56,47,4536.9
126,103,4,2,2,0
126,112,37,21,16,1737
126,113,2,1,1,0
126,117,4,3,1,0
126,118,12,5,7,478
126,119,61,33,28,3164.3
126,120,7,4,3,459.9
127,54,14,5,9,545
127,55,111,53,58,4757.6
127,56,165,83,82,6754.4
127,57,41,19,22,1503
127,58,9,3,6,189
127,59,43,22,21,1908.5
127,60,15,8,7,316.8
127,61,32,19,13,1114.6
127,62,214,104,110,8511.8
127,63,42,21,21,1510.8000000000002
127,64,5,3,2,193
127,66,6,2,4,235.8
127,67,8,3,5,268
127,68,4,2,2,0
127,70,148,81,67,6753.4
127,71,367,200,167,16160.6
127,72,37,19,18,1581
127,79,5,1,4,161
127,83,20,11,9,822
127,85,6,4,2,0
127,87,6,4,2,321
127,88,9,4,5,160
127,89,16,8,8,698.3
127,95,2,2,0,0
127,98,3,2,1,0
127,99,1,0,1,0
127,100,41,21,20,1374.3000000000002
127,101,132,68,64,5147.8
127,112,41,20,21,1599.3
127,115,2,2,0,0
127,116,11,4,7,352.8
127,117,18,9,9,537.6
127,118,19,10,9,815.1
127,119,65,34,31,2352.2