x,y,p,m,f,ta
0,0,29,15,14,1273.1
0,1,117,63,54,3877.6
0,2,125,59,66,5711.7
0,4,1,0,1,0
0,5,80,38,42,3269.4
0,6,29,19,10,1316.6
0,7,1,0,1,0
0,8,14,9,5,720.7
0,9,11,6,5,306
0,11,62,35,27,2918.8
0,23,5,2,3,282
0,24,13,6,7,373.1
0,33,89,41,48,3515.3
0,38,2,1,1,0
0,39,7,3,4,0
0,44,4,3,1,0
0,45,15,5,10,699
0,59,2,1,1,0
1,0,9,4,5,439.2
1,2,45,24,21,1838.7
1,3,37,16,21,1440.9
1,6,45,28,17,2105.6
1,7,39,19,20,1742.4
1,9,5,3,2,178
1,10,41,19,22,1568.2
1,11,118,66,52,4972
1,24,11,6,5,448.8
1,25,3,2,1,0
1,33,26,12,14,922.5
1,34,10,7,3,438
1,36,8,3,5,371.2
1,37,3,2,1,0
1,39,6,4,2,258
1,40,67,34,33,3456.6
1,41,121,68,53,4459.5
1,42,23,14,9,858.9
1,43,53,31,22,2378
1,58,4,3,1,0
1,59,11,8,3,343
2,3,21,9,12,1165.4
2,6,16,9,7,565.6
2,7,1,0,1,0
2,8,61,28,33,2406.2
2,9,48,25,23,2027
2,11,1,0,1,0
2,12,2,1,1,0
2,34,40,21,19,1871.9
2,37,2,2,0,0
2,40,1,0,1,0
2,41,11,4,7,279
2,43,7,4,3,0
2,45,6,3,3,233
2,46,8,5,3,228.9
2,57,36,21,15,1818
3,2,7,6,1,441.7
3,3,53,29,24,2230
3,4,36,20,16,1532
3,5,62,35,27,2847.5
3,6,18,9,9,660
3,7,34,17,17,1561.2
3,8,8,4,4,320
3,12,19,12,7,1015.5
3,26,31,16,15,1331.4
3,34,7,4,3,392.7
3,35,8,5,3,342.4
3,37,5,3,2,254
3,42,4,2,2,0
3,43,31,13,18,1748.3
3,44,29,14,15,1461.6
3,45,5,3,2,305
3,46,22,12,10,838.2
3,47,14,7,7,593.6
3,56,64,34,30,3390
3,57,55,27,28,2623.5
4,2,43,28,15,1950.9
4,3,17,6,11,913.1
4,7,4,2,2,0
4,12,23,14,9,853.6
4,21,1,1,0,0
4,26,23,11,12,1121.5
4,27,23,14,9,650
4,33,20,11,9,516.8
4,38,7,4,3,447.3
4,42,23,12,11,1165.6
4,43,36,17,19,1627.5
4,44,455,221,234,19210.8
4,47,4,2,2,0
4,53,3,1,2,0
4,54,69,32,37,2795.2
4,55,15,8,7,840.6
4,56,9,5,4,401.4
5,2,58,37,21,2647.4
5,7,7,5,2,459.9
5,8,22,12,10,886
5,9,2,1,1,0
5,13,8,5,3,306
5,14,10,6,4,689
5,15,6,5,1,337.2
5,20,6,3,3,282
5,21,8,6,2,297
5,26,1,1,0,0
5,27,15,8,7,848.8
5,32,8,4,4,332
5,38,7,2,5,363.3
5,43,61,30,31,2702.2
5,44,13,5,8,486
5,45,38,22,16,1642.2
5,50,3,2,1,0
5,51,8,4,4,382.2
5,52,6,4,2,334.8
5,53,28,14,14,1521.8
5,58,20,10,10,1204
5,59,13,9,4,764.4
6,2,469,245,224,18774.4
6,9,4,2,2,0
6,10,3,2,1,0
6,11,37,23,14,1462.8
6,12,23,13,10,1042.1
6,13,22,10,12,986.4
6,14,17,11,6,827.7
6,15,4,3,1,0
6,16,3,2,1,0
6,17,5,1,4,301
6,18,13,7,6,601
6,19,23,9,14,878
6,20,67,33,34,3269.1
6,21,36,18,18,1717.8
6,28,3,1,2,0
6,32,80,43,37,3561.6
6,33,6,5,1,111
6,44,11,7,4,679.8
6,45,5,2,3,343
6,49,3,1,2,0
7,1,3,0,3,0
7,2,170,89,81,6782
7,10,1,0,1,0
7,12,9,5,4,467.1
7,13,21,13,8,997.3
7,14,75,37,38,3637.3
7,15,27,16,11,1008.2
7,16,23,13,10,1250.8
7,17,5,3,2,326
7,19,7,4,3,319.2
7,21,12,6,6,390.4
7,22,33,18,15,1976.9
7,23,5,3,2,0
7,24,17,10,7,558
7,41,4,2,2,0
7,42,25,12,13,1202.8
7,49,1,1,0,0
8,1,35,16,19,1414
8,2,17,9,8,588.2
8,16,2,2,0,0
8,18,9,5,4,440.1
8,19,6,3,3,0
8,21,10,6,4,384
8,22,13,8,5,621
8,23,6,4,2,329
8,24,6,3,3,0
8,28,12,6,6,356
8,29,10,5,5,564.8
8,30,6,2,4,199.8
8,44,3,2,1,0
8,45,3,1,2,0
8,49,14,10,4,499
8,56,1,1,0,0
9,1,35,18,17,1778.9
9,24,14,8,6,603.9
9,25,7,3,4,436.1
9,26,16,9,7,540
9,27,21,10,11,961.1
9,28,7,4,3,364
9,31,26,14,12,1023
9,32,33,15,18,1308.3
9,33,8,6,2,282.4
9,45,2,2,0,0
9,46,40,23,17,1898.5
9,47,7,4,3,462.7
9,49,45,22,23,2275.8
10,1,15,6,9,805.5
10,2,16,10,6,596.7
10,24,14,10,4,758.6
10,25,49,25,24,2315.3
10,31,6,2,4,433.8
10,34,18,10,8,933
10,49,3,3,0,0
10,50,161,87,74,6681.5
10,51,56,26,30,2531.2
10,52,4,3,1,0
10,53,32,16,16,1404.7
10,54,61,36,25,2377.7
11,3,17,10,7,894.8
11,4,37,19,18,1729.5
11,5,24,15,9,943.2
11,24,3,2,1,0
11,25,19,9,10,841.7
11,34,5,3,2,348
11,35,24,11,13,1188.2
11,36,92,44,48,4458.1
11,37,36,21,15,1452.4
11,50,8,5,3,516
11,51,28,13,15,1045
11,53,9,5,4,387
11,55,1,1,0,0
12,5,157,77,80,6876.1
12,6,19,13,6,966.4
12,7,18,7,11,606.6
12,33,5,2,3,128
12,36,56,29,27,2341.6
12,37,17,10,7,1027.8
12,38,12,7,5,771.6
12,51,8,4,4,348.8
12,52,5,4,1,303
13,5,126,61,65,4830.6
13,6,133,62,71,5174.4
13,7,7,4,3,368.2
13,8,39,20,19,1505.3
13,9,39,22,17,1796.4
13,10,26,13,13,1151.8
13,24,12,5,7,651.6
13,38,18,8,10,860.4
13,39,19,11,8,831.6
13,40,13,8,5,495.2
13,41,19,9,10,699.2
13,52,5,4,1,292
14,1,15,8,7,430.1
14,2,9,6,3,302
14,3,22,14,8,786.6
14,5,124,64,60,4350.2
14,6,38,15,23,1375.6
14,7,3,2,1,0
14,8,9,4,5,412.2
14,9,14,6,8,684.4
14,11,22,14,8,749.7
14,12,1,0,1,0
14,23,2,2,0,0
14,24,3,2,1,0
14,40,45,26,19,2007
14,41,33,19,14,2135.7
14,42,55,27,28,2728.5
14,43,2,1,1,0
15,0,4,2,2,0
15,1,6,4,2,303
15,4,19,9,10,743.4
15,5,31,16,15,1590.4
15,9,11,6,5,742.5
15,10,22,8,14,869
15,12,27,10,17,1325.1
15,24,9,3,6,396.9
15,40,3,1,2,0
15,41,102,52,50,4015.8
15,42,30,16,14,1490.5
15,43,54,27,27,2694.9
15,44,21,13,8,1094.1
16,0,4,3,1,0
16,4,56,31,25,1886.7
16,11,2,1,1,0
16,12,8,2,6,568
16,13,32,19,13,1819.4
16,15,205,101,104,8445.1
16,16,81,34,47,3855.6
16,23,25,16,9,1284
17,13,1,1,0,0
17,17,7,3,4,316
17,18,63,33,30,2485.2
17,19,188,98,90,8185.5
17,20,140,69,71,5386.2
17,21,109,65,44,4983.6
17,22,162,78,84,6274.2
17,23,659,332,327,28463.8
17,29,15,7,8,918.4
18,19,8,5,3,448.8
18,20,3,1,2,0
18,21,37,17,20,1568.8
18,22,9,4,5,224
18,23,30,18,12,1590
18,24,95,50,45,4310.4
18,25,3,2,1,0
18,27,23,14,9,1132.6
18,28,9,6,3,408.8
19,11,2,1,1,0
19,12,190,100,90,9368.4
19,13,470,253,217,20070.1
19,24,16,9,7,924.8
19,25,16,8,8,526.5
19,26,20,11,9,1003.5
19,27,22,11,11,954.4
20,11,5,1,4,256
20,12,32,17,15,1793
20,13,5,4,1,220
20,21,11,5,6,304.2
20,50,3,2,1,0
20,51,6,4,2,0
20,58,138,71,67,6000.5
21,9,3,3,0,0
21,24,20,7,13,516.8
21,33,32,17,15,1376
21,34,33,21,12,1531.3
21,49,7,4,3,408.8
21,50,6,4,2,352.8
21,51,4,2,2,0
22,26,31,15,16,1508
22,27,5,2,3,247
22,29,34,16,18,1723
22,30,19,8,11,672.5
22,31,5,2,3,0
22,32,30,16,14,1762.5
22,33,51,29,22,2253.6
22,34,10,4,6,530
22,37,5,2,3,0
22,38,3,2,1,0
22,50,14,7,7,595
23,18,11,7,4,344
23,19,57,34,23,2246.4
23,20,156,78,78,5689.3
23,21,115,61,54,5134.2
23,22,84,44,40,3951.6
23,23,3,1,2,0
23,25,323,167,156,14190
23,26,5,3,2,169
23,35,74,36,38,3379.2
23,36,28,19,9,1411.8
23,47,4,2,2,0
23,50,56,30,26,2570.4
23,51,32,19,13,1376
24,16,2,1,1,0
24,17,8,4,4,194
24,18,11,6,5,502
24,20,31,19,12,1429.6
24,21,139,75,64,6170.2
24,22,118,65,53,5498.8
24,23,11,5,6,628.2
24,24,61,29,32,2823.1
24,25,10,8,2,420
24,35,42,22,20,1659
24,36,28,15,13,1108.8
24,46,1,0,1,0
24,53,3,2,1,0
24,54,10,5,5,322.8
25,15,5,3,2,124
25,21,18,9,9,1105.2
25,22,10,7,3,572.4
25,23,2,1,1,0
25,36,42,23,19,2083
25,40,10,6,4,482.4
25,41,1,0,1,0
25,42,2,1,1,0
25,53,13,8,5,442
25,54,2,1,1,0
25,55,18,10,8,1030.5
25,56,5,3,2,305
26,21,17,8,9,703.6
26,22,4,2,2,0
26,34,1,1,0,0
26,35,56,32,24,2084.6
26,36,26,15,11,923.3
26,37,34,13,21,1564.2
26,38,2,1,1,0
26,40,12,7,5,530.4
26,51,2,2,0,0
26,52,9,4,5,360
27,21,27,11,16,1081.5
27,38,32,20,12,1683.7
27,39,23,12,11,1042.5
27,40,3,1,2,0
27,43,3,1,2,0
27,44,2,1,1,0
28,3,4,3,1,0
28,21,66,39,27,3392.6
28,39,21,14,7,852.2
28,40,50,24,26,2267
28,44,14,6,8,864.3
29,19,5,2,3,309
29,20,125,71,54,5192.1
29,37,14,4,10,621.4
29,40,4,2,2,0
29,41,1,0,1,0
29,44,33,13,20,1078.4
29,47,22,14,8,938.5
29,49,538,271,267,19244.2
29,50,1877,949,928,78209.9
30,19,133,66,67,6157.5
30,20,87,49,38,3123.3
30,36,835,420,415,34016.6
30,43,8,4,4,375.2
30,44,13,9,4,630.3
30,45,1,1,0,0
30,47,17,11,6,744.6
30,48,3,1,2,0
30,50,86,47,39,2760.6
31,18,107,55,52,5096
31,19,63,37,26,3391.2
31,35,240,128,112,9274.4
31,36,24,14,10,905.6
31,37,14,7,7,491.4
31,39,2,2,0,0
32,18,53,30,23,2692.4
32,32,2,1,1,0
32,33,27,17,10,1141.7
32,34,158,81,77,5943.9
32,35,1266,609,657,50556.7
32,36,443,230,213,17212.1
32,37,61,27,34,2235.1
32,39,43,18,25,1616.5
32,40,23,12,11,1184.7
32,41,24,13,11,779
33,31,15,7,8,625.5
33,32,8,6,2,272
33,33,3,3,0,0
33,34,81,46,35,3598.8
33,37,66,38,28,2585.6
33,39,7,4,3,0
33,40,1,1,0,0
33,41,23,12,11,542.8
33,42,19,12,7,432
33,60,3,2,1,0
33,61,1,0,1,0
34,34,58,36,22,2519.1
34,38,1,1,0,0
34,39,9,7,2,280
34,40,7,5,2,0
34,41,18,12,6,555.8
34,42,21,8,13,714.6
34,43,10,6,4,251.3
34,44,2,1,1,0
34,45,9,4,5,497.7
35,33,19,8,11,603.5
35,34,59,31,28,2218.6
35,40,19,10,9,850
35,41,70,34,36,2786
35,44,32,19,13,1700
36,31,60,32,28,2357.5
36,32,49,21,28,2207.4
36,33,61,31,30,2265
36,43,9,4,5,212
36,44,53,31,22,2349.6
36,62,1,1,0,0
36,67,2,2,0,0
36,68,4,4,0,0
36,69,1,1,0,0
37,25,6,3,3,0
37,27,12,8,4,288
37,28,6,3,3,205.8
37,30,15,7,8,769.2
37,31,18,9,9,660.6
37,43,28,15,13,1099.6
37,44,101,49,52,3570
38,24,45,19,26,1717.1
38,25,2,2,0,0
38,27,6,4,2,259
38,28,12,5,7,218
38,29,14,7,7,483
38,30,21,15,6,827.7
38,41,10,6,4,612
38,42,3,2,1,0
38,43,10,7,3,500
38,61,1,1,0,0
38,63,1,1,0,0
39,23,7,5,2,406.8
39,39,10,7,3,389
39,41,1,1,0,0
39,42,40,20,20,1749.3
39,43,9,5,4,486
39,64,12,7,5,777.6
39,65,11,6,5,319
40,22,10,4,6,333
40,23,2,1,1,0
40,47,1,1,0,0
40,64,22,12,10,1189
41,22,6,4,2,280
41,55,11,6,5,698.5
42,20,3,1,2,0
42,21,7,6,1,0
42,61,5,4,1,343
42,62,13,8,5,702.4
43,19,2,1,1,0
43,44,1,1,0,0
43,49,26,15,11,1260
43,63,52,27,25,2506.4
43,64,34,21,13,1019.9
44,85,109,60,49,4776.8
45,43,2,1,1,0
45,52,11,5,6,527.4
45,58,3,2,1,0
45,85,109,62,47,4153.3
46,41,10,6,4,485
46,42,4,3,1,0
46,53,18,9,9,918.1
46,84,2,1,1,0
47,40,5,3,2,182
47,41,41,20,21,2141.7
47,47,5,2,3,139
47,53,4,3,1,0
47,84,6,3,3,0
48,37,5,4,1,275
48,40,6,3,3,267
48,41,19,10,9,457.6
48,43,31,15,16,1189
48,44,13,5,8,578.5
48,47,11,7,4,350
48,54,26,17,9,933.4
48,55,2,2,0,0
48,77,27,14,13,1304.1
48,78,42,23,19,2124.6
48,79,4,3,1,0
49,36,6,4,2,162
49,37,2,1,1,0
49,38,7,3,4,301.7
49,40,26,13,13,1027.5
49,41,33,19,14,880.6
49,43,41,21,20,2028.8
49,47,34,16,18,1639.5
49,48,15,6,9,620.4
49,49,11,4,7,539.2
49,50,7,4,3,485.1
49,51,7,5,2,389.9
49,54,8,4,4,254.1
49,63,8,4,4,524
49,64,8,6,2,0
49,65,55,31,24,2874.5
49,77,271,132,139,11298
49,78,105,58,47,4399.5
49,81,1,1,0,0
50,36,8,2,6,368
50,41,6,4,2,0
50,42,50,26,24,2107
50,43,9,6,3,465.3
50,46,135,68,67,4686.3
50,47,294,144,150,12856.1
50,48,21,15,6,834.5
50,49,13,7,6,573.1
50,50,9,5,4,307.3
50,51,5,3,2,189
50,52,32,17,15,1587.2
50,65,26,16,10,1315.6
50,66,9,8,1,376
50,79,6,3,3,265.8
50,81,1,0,1,0
50,82,1,1,0,0
50,83,250,149,101,10450
51,35,2,1,1,0
51,36,9,5,4,435.2
51,39,9,5,4,320
51,42,19,10,9,689.7
51,45,11,6,5,317.9
51,46,43,20,23,1745.3
51,52,17,9,8,687.6
51,83,17,8,9,680
51,84,68,36,32,2884.2
52,35,15,9,6,881.7
52,37,6,4,2,352.2
52,38,19,11,8,817.6
52,53,11,5,6,525.8
52,63,9,7,2,256
52,64,4,1,3,0
53,35,2,1,1,0
53,36,12,5,7,204
53,37,3,2,1,0
53,53,13,6,7,284.9
53,60,2,1,1,0
54,52,4,1,3,0
54,53,27,14,13,1179.3
54,60,6,3,3,369
54,61,9,6,3,220.2
54,62,4,3,1,0
54,64,328,177,151,15280.3
54,65,291,155,136,12684
55,51,19,12,7,643
55,52,21,12,9,877.8
55,53,1,1,0,0
55,54,13,7,6,478.5
56,55,4,1,3,0
56,59,2,1,1,0
57,54,3,3,0,0
57,56,7,5,2,483.7
58,56,7,5,2,282
58,58,12,8,4,329
58,59,1,0,1,0
59,56,3,2,1,0
60,57,1,1,0,0
62,71,9,6,3,378
63,57,3,1,2,0
63,69,9,5,4,347.4
63,70,37,20,17,1720
63,71,2,2,0,0
63,90,5,4,1,0
63,91,4,3,1,0
64,57,1,1,0,0
64,58,1,1,0,0
64,91,1,1,0,0
64,95,1,1,0,0
65,58,8,4,4,315
65,59,3,2,1,0
65,94,2,2,0,0
66,54,30,13,17,1263
66,55,72,37,35,2635.2
66,71,7,3,4,225
66,83,1,0,1,0
66,88,1,1,0,0
66,91,4,2,2,0
67,43,3,2,1,0
67,54,185,100,85,6583.2
67,55,105,58,47,4872
67,56,7,5,2,93
67,57,9,5,4,331
67,59,20,11,9,876
67,60,15,8,7,691.5
67,69,2,1,1,0
67,70,1,1,0,0
67,83,16,9,7,796.8
67,92,1,1,0,0
68,45,13,6,7,534.4
68,46,8,3,5,243.2
68,53,18,10,8,802.8
68,68,6,4,2,0
68,92,2,1,1,0
68,93,1,1,0,0
68,99,4,3,1,0
69,46,5,3,2,297
69,47,23,11,12,1076.5
69,48,25,13,12,633
69,49,73,30,43,2985.1
69,50,7,4,3,377.3
69,54,6,3,3,226.8
69,94,1,1,0,0
69,97,17,9,8,851.7
69,98,3,2,1,0
70,49,111,55,56,4508.6
70,50,86,43,43,3418
70,51,24,12,12,776.6
70,52,4,2,2,0
70,53,1,0,1,0
70,61,4,2,2,0
70,64,7,3,4,301
70,65,18,10,8,897.4
70,97,53,26,27,1953.3
71,49,16,9,7,457.6
71,50,20,13,7,818
71,58,1,1,0,0
71,61,11,8,3,499.4
71,65,3,2,1,0
71,83,21,14,7,1032.8
71,84,9,5,4,390.6
72,1,12,7,5,529.2
72,46,111,63,48,4554
72,47,50,25,25,1344
72,50,2224,1075,1149,78587.6
72,51,862,419,443,36462.6
72,59,2,1,1,0
72,61,7,5,2,422.1
72,63,3,2,1,0
72,67,3,2,1,0
72,68,6,4,2,261
72,83,8,4,4,237
72,84,3,1,2,0
73,47,101,57,44,4460
73,48,110,57,53,3948.4
73,49,350,186,164,11911
73,50,863,462,401,28247
73,51,2928,1483,1445,118523.1
73,52,1543,738,805,61293.4
73,53,300,165,135,9390
73,59,8,3,5,299.2
73,66,16,8,8,957
73,67,26,14,12,1110.6
73,68,8,6,2,367
73,83,10,7,3,509
73,85,1,1,0,0
73,86,1,1,0,0
74,0,1,1,0,0
74,45,4,2,2,0
74,46,24,14,10,853.2
74,47,8,4,4,161
74,48,36,18,18,1220.4
74,49,108,53,55,4018
74,50,101,51,50,3842.2
74,51,919,464,455,29202
74,52,1424,718,706,53408.5
74,53,113,62,51,4520
74,55,5,3,2,149
74,59,6,2,4,346.2
74,60,111,56,55,4873.1
74,63,6,4,2,309
74,66,12,7,5,428.8
74,67,8,5,3,562.4
74,68,13,8,5,845
74,82,6,3,3,201
74,83,2,1,1,0
74,84,6,3,3,232.2
74,85,12,6,6,678.2
74,86,3,2,1,0
75,46,14,9,5,560.3
75,49,2,1,1,0
75,50,3,2,1,0
75,51,2272,1120,1152,81086.8
75,52,951,471,480,37652.1
75,55,37,22,15,1467.8
75,60,26,14,12,1373.9
75,71,5,3,2,0
75,72,14,9,5,590.7
75,87,15,7,8,756
75,88,149,76,73,4555.2
75,89,100,52,48,3929.8
75,90,640,332,308,26529.7
75,91,1995,983,1012,86945.5
75,92,1627,805,822,57173
76,50,148,83,65,5967.6
76,51,1510,757,753,44079.6
76,52,508,254,254,14845.6
76,55,45,27,18,1436.4
76,69,3,2,1,0
76,70,2,1,1,0
76,72,3,2,1,0
76,75,13,5,8,698.5
76,76,4,2,2,0
76,89,775,390,385,27745
76,90,625,310,315,22430.6
76,91,3355,1695,1660,127697.9
76,92,714,363,351,22874.2
76,93,52,30,22,1424.8
77,0,85,42,43,3451.4
77,45,5,3,2,295
77,49,80,38,42,2888
77,50,100,50,50,3921.8
77,52,79,41,38,2926.1
77,53,120,70,50,3923.7
77,54,22,11,11,877.4
77,55,75,42,33,2854.3
77,70,2,1,1,0
77,77,8,4,4,340
77,78,1,1,0,0
77,84,4,2,2,0
77,85,13,6,7,457.6
77,86,2,1,1,0
77,93,1,1,0,0
77,94,206,110,96,6983.4
77,95,10,5,5,517
77,110,36,22,14,1542.6
78,43,30,18,12,861
78,44,13,5,8,377.3
78,45,2,1,1,0
78,49,317,164,153,9600
78,50,165,89,76,6150.8
78,55,424,210,214,15011.4
78,56,8,4,4,150
78,94,3,2,1,0
78,95,2,1,1,0
78,110,1,1,0,0
79,2,4,3,1,0
79,3,14,7,7,743.4
79,4,46,26,20,2012.2
79,35,2,1,1,0
79,43,22,10,12,568.1
79,79,56,33,23,2480.8
79,80,27,11,16,1001.6
79,81,6,3,3,205.8
79,83,4,3,1,0
79,110,5,3,2,351
79,114,4,4,0,0
79,115,21,15,6,753.6
80,5,18,6,12,559.5
80,33,4,2,2,0
80,83,9,4,5,260
80,109,1,1,0,0
80,110,14,8,6,546
80,111,6,4,2,253.8
80,113,1,1,0,0
81,31,3,0,3,0
81,111,20,12,8,912
82,6,37,22,15,1472.6
82,7,4,3,1,0
82,82,18,8,10,679.5
82,83,292,162,130,12437.6
82,84,93,51,42,4228.3
82,85,9,6,3,375.9
82,111,7,3,4,163.1
83,8,103,52,51,3629.9
83,83,77,43,34,3910.9
84,8,10,4,6,389
84,22,64,34,30,2515.2
84,23,8,4,4,436
84,45,1,1,0,0
84,83,46,24,22,2265.4
84,85,13,7,6,727
85,9,3,2,1,0
85,23,12,8,4,762
85,24,131,71,60,5501.3
85,25,12,6,6,375.6
85,83,11,6,5,574
85,85,17,8,9,1024.6
85,87,5,4,1,0
86,82,6,4,2,244.2
87,11,1,1,0,0
87,82,35,22,13,1788.5
87,84,1,0,1,0
87,94,6,5,1,0
88,11,11,7,4,676.5
88,82,14,7,7,336
88,83,5,3,2,318
89,11,28,16,12,1120.8
89,16,3,3,0,0
89,17,1,0,1,0
89,81,28,14,14,700
89,82,8,6,2,487.2
90,75,2,1,1,0
90,98,9,6,3,0
90,101,2,1,1,0
90,112,784,405,379,34413
91,75,1,1,0,0
91,100,17,8,9,1099.5
91,101,6,4,2,0
91,112,214,116,98,9512.9
92,18,7,3,4,254.8
92,19,5,4,1,0
92,80,4,2,2,0
92,81,21,13,8,1037.7
92,91,1,1,0,0
92,95,6,4,2,310.8
92,101,3,1,2,0
93,21,1,1,0,0
93,40,1,1,0,0
93,80,22,12,10,765.6
93,81,12,8,4,193.6
93,90,3,2,1,0
93,91,51,24,27,2291.6
93,95,5,3,2,403
94,91,68,36,32,3393.2
94,92,9,5,4,249
95,27,1,1,0,0
96,21,23,15,8,1031.7
96,36,2,2,0,0
96,114,40,23,17,2160
97,114,17,12,5,741.2
98,30,8,4,4,335.2
100,21,1,1,0,0
100,22,1,0,1,0
102,67,18,10,8,920.8
102,68,17,4,13,647.6
102,69,12,7,5,541.2
102,70,34,18,16,1552.6
102,71,2,2,0,0
102,84,16,9,7,737.6
102,85,37,21,16,1857.2
102,86,11,5,6,0
102,87,25,11,14,1467
102,88,3,1,2,0
102,120,100,57,43,4930
103,62,1,1,0,0
103,72,8,4,4,302.4
103,75,13,7,6,448.8
103,76,9,4,5,380.7
103,77,1,1,0,0
103,78,20,13,7,1054
103,84,13,5,8,870.8
103,85,4,2,2,0
103,87,8,5,3,418.4
103,88,1,0,1,0
103,120,12,7,5,642
104,24,20,12,8,962.6
104,57,8,5,3,340
104,58,9,6,3,514.8
104,59,53,26,27,1619.6
104,60,410,203,207,15550.6
104,61,1046,517,529,43883.4
104,62,9,7,2,323.1
104,72,1,1,0,0
104,73,47,23,24,1783.1
104,74,14,8,6,660
104,75,67,34,33,3401.2
104,76,64,34,30,2695.3
104,77,1,0,1,0
104,79,3,2,1,0
104,85,3,1,2,0
104,90,1,1,0,0
105,25,1,1,0,0
105,56,14,6,8,586
105,57,33,19,14,1383.8
105,58,2,1,1,0
105,59,10,6,4,414
105,60,607,289,318,24962.2
105,61,418,217,201,16895.6
105,62,1,1,0,0
105,63,10,7,3,421
105,73,1,1,0,0
105,74,22,12,10,1042.8
105,75,9,5,4,235.8
105,76,3,2,1,0
105,81,3,3,0,0
105,82,2,1,1,0
105,83,8,4,4,348
105,84,9,5,4,351.9
105,85,5,3,2,97
105,91,1,0,1,0
106,53,6,3,3,229.8
106,60,5,2,3,270
106,61,200,111,89,8200.8
106,62,56,25,31,2109.1
106,63,47,24,23,1720.4
106,75,3,1,2,0
106,83,2,1,1,0
106,84,11,6,5,547.2
107,60,9,4,5,555.3
107,61,66,29,37,2497.8
107,62,69,38,31,2600
108,14,1,1,0,0
108,49,4,2,2,0
108,62,24,15,9,1003.2
109,46,3,1,2,0
109,49,31,16,15,1593.6
109,50,3,2,1,0
109,63,8,3,5,355.2
109,64,3,1,2,0
109,113,3,2,1,0
110,48,2,1,1,0
110,49,5,4,1,0
110,77,1,0,1,0
110,101,2,1,1,0
110,102,3,1,2,0
110,122,89,53,36,4381.8
111,46,2,1,1,0
111,77,7,3,4,238.7
111,79,1,0,1,0
111,80,2,1,1,0
111,81,5,4,1,340
111,101,24,12,12,1016.6
111,108,2,2,0,0
111,109,3,2,1,0
111,110,1,1,0,0
111,114,16,9,7,814.4
112,75,4,2,2,0
112,77,18,4,14,1195.2
112,78,3,2,1,0
112,82,11,7,4,587.7
112,83,1,0,1,0
112,110,2,1,1,0
112,117,1,1,0,0
112,118,22,15,7,1012
112,119,57,31,26,2781.6
113,75,4,2,2,0
113,76,4,4,0,0
113,77,56,35,21,2720.7
113,78,55,28,27,2644.2
113,84,2,1,1,0
114,25,14,8,6,702
114,26,3,1,2,0
114,77,1,0,1,0
114,78,42,28,14,1961.4
114,79,3,2,1,0
114,88,7,5,2,459.2
114,115,1624,824,800,70882.5
114,116,832,450,382,33562.9
114,117,2,2,0,0
115,28,1,0,1,0
115,88,3,2,1,0
115,89,7,5,2,0
115,115,246,125,121,9695
115,116,185,102,83,7511
116,28,3,3,0,0
116,36,3,0,3,0
116,91,4,4,0,0
117,28,24,13,11,975.2
117,29,10,6,4,410
117,93,1,1,0,0
117,94,3,2,1,0
118,28,4,2,2,0
118,29,76,43,33,2931.2
118,94,1,1,0,0
118,95,1,1,0,0
119,29,155,86,69,5629.6
119,30,123,62,61,5133
120,29,11,8,3,272.8
120,30,784,377,407,29735.3
120,31,591,309,282,25565.9
120,81,1,0,1,0
121,30,269,133,136,11754.3
121,31,374,193,181,15849.6
122,30,36,17,19,1252.4
123,30,1,1,0,0
124,29,4,3,1,0
124,30,9,3,6,309.6
125,29,17,9,8,447.2
125,30,6,3,3,0
126,16,2,1,1,0
126,17,3,1,2,0
126,19,5,3,2,0
126,22,1,1,0,0
126,28,3,2,1,0
126,29,22,9,13,759.5
126,30,8,5,3,311
126,33,1,1,0,0
126,44,14,7,7,658.9
127,28,44,22,22,1745.6
127,33,7,2,5,259.7
127,35,10,5,5,139.2
127,38,2,1,1,0
127,42,3,1,2,0