x,y,p,m,f,ta
0,5,12,7,5,471.6
0,6,5,4,1,332
0,67,3,1,2,0
0,70,7,4,3,261.1
0,71,4,2,2,0
0,75,10,5,5,547
0,82,22,12,10,948.2
0,83,3,1,2,0
0,87,7,4,3,443.1
0,100,1,1,0,0
0,101,8,4,4,344.8
0,103,12,5,7,670.8
0,106,1,0,1,0
0,109,22,12,10,888.8
0,110,2,1,1,0
0,111,5,4,1,226
0,113,4,3,1,0
0,114,24,12,12,924
0,115,21,11,10,1589.7
0,124,25,13,12,777.5
1,5,4,3,1,0
1,6,20,6,14,762
1,50,5,2,3,145
1,70,12,6,6,519.6
1,75,12,7,5,537.6
1,82,7,3,4,506.8
1,83,28,14,14,1226.4
1,87,7,3,4,389.2
1,88,43,21,22,2132.8
1,89,22,11,11,1163.8
1,99,29,15,14,1064.3
1,100,4,3,1,0
1,109,4,3,1,0
1,112,5,4,1,332
1,114,11,7,4,437.8
1,115,7,4,3,448
1,117,1,0,1,0
1,119,1,0,1,0
1,124,4,1,3,0
2,4,8,6,2,280.8
2,5,22,12,10,897.6
2,52,2,1,1,0
2,64,13,6,7,743.6
2,70,2,2,0,0
2,72,16,8,8,672
2,73,18,10,8,792
2,74,22,12,10,1089
2,75,46,24,22,1665.2
2,83,31,14,17,1178
2,88,37,21,16,1502.2
2,89,7,5,2,417.9
2,90,11,6,5,479.6
2,96,2,1,1,0
2,97,36,16,20,1724.4
2,98,15,5,10,504
2,99,84,42,42,3679.2
2,114,23,12,11,1071.8
2,115,7,4,3,214.2
2,117,7,5,2,165.9
2,125,5,2,3,355
2,126,1,1,0,0
3,3,8,4,4,240.8
3,52,7,4,3,300.3
3,53,14,4,10,568.4
3,63,1,1,0,0
3,64,12,5,7,525.6
3,65,19,9,10,704.9
3,72,35,20,15,1424.5
3,73,11,6,5,363
3,74,14,7,7,609
3,75,19,9,10,982.3
3,76,66,36,30,3201
3,82,27,14,13,1128.6
3,83,11,7,4,587.4
3,84,14,8,6,407.4
3,99,39,21,18,1450.8
3,100,18,9,9,1031.4
3,104,2,1,1,0
3,105,7,2,5,396.9
3,106,4,1,3,0
3,107,5,2,3,318
3,113,3,2,1,0
3,116,30,15,15,1566
3,117,2,1,1,0
4,2,19,9,10,674.5
4,3,14,8,6,614.6
4,53,13,5,8,561.6
4,54,8,4,4,316
4,64,2,1,1,0
4,70,6,4,2,166.2
4,71,2,1,1,0
4,75,3,3,0,0
4,76,9,5,4,194.4
4,77,20,8,12,630
4,78,1,0,1,0
4,80,3,1,2,0
4,81,3,2,1,0
4,84,15,8,7,829.5
4,85,30,15,15,1110
4,99,7,4,3,252.7
4,100,27,13,14,982.8
4,101,13,5,8,621.4
4,102,19,7,12,811.3
4,103,33,18,15,1689.6
4,104,3,1,2,0
4,105,31,17,14,1267.9
4,106,12,6,6,417.6
4,114,7,3,4,184.8
4,126,1,0,1,0
4,127,6,3,3,390
5,1,16,8,8,606.4
5,2,16,9,7,686.4
5,3,6,4,2,324
5,53,1,0,1,0
5,54,13,9,4,631.8
5,63,1,0,1,0
5,71,7,4,3,406.7
5,76,12,6,6,487.2
5,77,1,0,1,0
5,78,7,2,5,293.3
5,79,5,3,2,194
5,80,6,4,2,316.8
5,81,6,1,5,112.8
5,85,4,2,2,0
5,86,1,1,0,0
5,92,18,11,7,696.6
5,99,4,3,1,0
5,101,10,5,5,543
5,104,32,13,19,1379.2
5,107,7,3,4,310.1
5,113,10,7,3,423
5,116,3,2,1,0
6,0,1,1,0,0
6,1,5,2,3,111
6,54,12,7,5,483.6
6,63,10,6,4,609
6,72,2,1,1,0
6,77,13,7,6,406.9
6,90,7,4,3,280.7
6,92,20,10,10,850
6,93,8,4,4,240
6,99,4,3,1,0
6,104,110,49,61,5456
6,107,9,5,4,482.4
6,116,7,3,4,300.3
6,119,5,3,2,328
6,120,6,3,3,234
7,0,15,8,7,712.5
7,1,9,5,4,414
7,55,31,16,15,1413.6
7,56,60,30,30,2106
7,57,26,15,11,884
7,58,6,3,3,223.8
7,59,38,19,19,1903.8
7,60,3,2,1,0
7,78,9,6,3,325.8
7,91,36,20,16,1515.6
7,93,14,6,8,957.6
7,99,2,1,1,0
7,100,9,5,4,424.8
7,101,6,3,3,379.2
7,103,2,1,1,0
7,104,99,47,52,4534.2
7,110,1,1,0,0
7,118,10,6,4,478
7,121,6,3,3,225
8,0,40,17,23,2004
8,57,11,5,6,311.3
8,58,18,11,7,874.8
8,59,46,24,22,1789.4
8,91,62,33,29,3118.6
8,93,16,10,6,889.6
8,100,79,42,37,3618.2
8,101,25,14,11,1272.5
8,102,2,1,1,0
8,104,27,17,10,685.8
8,105,10,7,3,205
8,106,4,2,2,0
8,107,6,3,3,382.8
8,109,1,1,0,0
8,111,8,3,5,442.4
8,112,5,3,2,291
8,118,5,4,1,134
8,119,23,8,15,1104
9,0,6,2,4,261
9,63,9,7,2,366.3
9,79,1,1,0,0
9,80,8,5,3,320
9,91,14,7,7,582.4
9,92,45,23,22,2070
9,93,22,11,11,794.2
9,100,14,8,6,715.4
9,104,8,4,4,314.4
9,105,5,4,1,213
9,118,1,1,0,0
9,119,33,16,17,1485
10,63,6,3,3,405
10,73,9,4,5,393.3
10,74,16,10,6,763.2
10,78,11,5,6,261.8
10,79,10,4,6,393
10,84,4,2,2,0
10,100,25,13,12,790
10,105,8,4,4,315.2
10,119,24,15,9,976.8
11,56,7,2,5,196
11,57,44,21,23,1628
11,77,1,1,0,0
11,82,21,12,9,764.4
11,83,7,3,4,382.2
11,94,4,2,2,0
11,98,4,2,2,0
11,99,11,5,6,381.7
11,100,16,8,8,806.4
11,105,10,4,6,583
11,115,15,6,9,550.5
11,118,4,2,2,0
11,119,13,7,6,509.6
11,120,37,21,16,1309.8
11,121,1,0,1,0
12,46,2,1,1,0
12,48,4,2,2,0
12,50,2,1,1,0
12,51,13,7,6,634.4
12,52,145,66,79,5408.5
12,53,23,10,13,648.6
12,54,7,3,4,291.9
12,61,80,39,41,3656
12,66,1,0,1,0
12,67,13,6,7,626.6
12,68,8,4,4,247.2
12,76,10,5,5,335
12,80,35,19,16,1225
12,81,34,21,13,1564
12,82,13,2,11,1162.2
12,89,6,2,4,279
12,94,21,12,9,1089.9
12,95,8,4,4,272
12,105,11,5,6,509.3
12,106,2,1,1,0
12,108,6,2,4,172.2
12,113,8,4,4,342.4
12,117,6,2,4,360
12,118,26,13,13,1237.6
12,119,51,27,24,1999.2
12,120,9,3,6,351
13,51,8,5,3,323.2
13,52,287,137,150,10532.9
13,53,291,150,141,12629.4
13,60,19,9,10,807.5
13,61,43,26,17,1698.5
13,62,2,1,1,0
13,65,45,23,22,2214
13,66,13,8,5,616.2
13,68,6,3,3,250.8
13,69,2,1,1,0
13,71,49,23,26,1778.7
13,74,22,11,11,697.4
13,76,12,5,7,372
13,79,23,11,12,1131.6
13,81,8,6,2,352
13,85,7,3,4,403.9
13,87,2,1,1,0
13,88,5,2,3,192
13,89,2,2,0,0
13,91,2,1,1,0
13,96,11,5,6,715
13,105,26,15,11,1261
13,106,6,4,2,207
13,108,8,5,3,296
13,109,1,1,0,0
13,111,6,3,3,234
13,112,18,9,9,649.8
13,113,8,6,2,420.8
13,114,6,4,2,325.8
13,115,10,7,3,385
13,117,2,1,1,0
13,118,4,1,3,0
13,119,34,20,14,1288.6
13,120,8,5,3,532.8
14,52,54,26,28,1998
14,53,1500,762,738,66000
14,54,82,44,38,2738.8
14,62,6,2,4,229.8
14,63,69,37,32,3532.8
14,64,101,48,53,4130.9
14,65,40,22,18,1452
14,70,7,3,4,347.9
14,71,28,16,12,1027.6
14,72,19,12,7,644.1
14,73,182,89,93,7462
14,74,36,19,17,1188
14,75,8,5,3,506.4
14,77,13,6,7,283.4
14,78,15,7,8,577.5
14,85,22,10,12,987.8
14,86,17,9,8,771.8
14,90,9,5,4,233.1
14,92,43,25,18,1715.7
14,97,4,1,3,0
14,105,13,8,5,565.5
14,108,12,6,6,728.4
14,109,8,4,4,432.8
14,124,12,4,8,572.4
14,127,3,2,1,0
15,52,287,160,127,11910.5
15,53,892,413,479,42459.2
15,63,9,5,4,342
15,64,46,25,21,1812.4
15,77,109,49,60,4022.1
15,79,1,0,1,0
15,86,29,15,14,1293.4
15,87,1,0,1,0
15,90,2,1,1,0
15,92,15,8,7,709.5
15,124,10,6,4,488
15,127,26,9,17,1001
16,52,492,257,235,19138.8
16,77,45,27,18,2034
16,78,27,16,11,888.3
16,79,29,16,13,959.9
16,87,7,2,5,373.8
16,91,31,21,10,1193.5
16,92,2,1,1,0
16,104,1,0,1,0
16,105,24,14,10,1372.8
16,108,6,2,4,238.8
16,117,7,4,3,300.3
16,118,18,9,9,932.4
16,120,10,5,5,399
16,126,5,3,2,278
16,127,16,10,6,776
17,51,56,32,24,2100
17,52,164,85,79,5969.6
17,63,9,4,5,377.1
17,74,3,1,2,0
17,77,3,2,1,0
17,78,18,9,9,750.6
17,79,2,2,0,0
17,88,16,8,8,638.4
17,91,11,4,7,343.2
17,104,26,17,9,1336.4
17,105,1,1,0,0
17,106,22,10,12,781
17,108,4,3,1,0
17,115,93,51,42,4082.7
17,116,30,19,11,1122
17,117,12,7,5,510
17,118,9,5,4,330.3
17,119,5,4,1,236
17,120,3,1,2,0
17,125,12,7,5,496.8
17,126,15,10,5,627
17,127,28,14,14,957.6
18,50,1,0,1,0
18,51,363,180,183,13975.5
18,62,10,5,5,463
18,72,1,1,0,0
18,73,6,3,3,405
18,74,2,1,1,0
18,77,1,1,0,0
18,78,20,9,11,872
18,79,51,23,28,1927.8
18,85,9,3,6,475.2
18,88,13,7,6,660.4
18,92,4,2,2,0
18,104,20,10,10,918
18,105,1,0,1,0
18,106,11,6,5,302.5
18,108,7,2,5,172.2
18,109,2,1,1,0
18,114,3,1,2,0
18,115,13,6,7,683.8
18,117,3,3,0,0
18,118,4,1,3,0
18,119,18,7,11,588.6
18,120,3,1,2,0
18,126,17,10,7,933.3
18,127,4,2,2,0
19,50,15,9,6,459
19,51,7,4,3,303.1
19,61,14,10,4,476
19,75,26,12,14,1068.6
19,76,53,27,26,1876.2
19,77,4,2,2,0
19,79,36,19,17,1447.2
19,85,4,3,1,0
19,88,4,2,2,0
19,92,27,15,12,1393.2
19,103,32,16,16,1344
19,104,25,15,10,1327.5
19,105,13,6,7,673.4
19,106,12,7,5,474
19,113,15,9,6,726
19,114,5,4,1,174
19,118,16,10,6,550.4
19,119,154,65,89,7530.6
19,120,83,40,43,4332.6
19,121,4,3,1,0
20,50,18,8,10,772.2
20,71,4,3,1,0
20,72,15,7,8,481.5
20,75,16,7,9,668.8
20,79,18,11,7,955.8
20,86,20,10,10,802
20,88,11,6,5,524.7
20,91,5,4,1,184
20,92,62,37,25,2870.6
20,102,4,2,2,0
20,103,87,44,43,3610.5
20,104,4,2,2,0
20,105,7,3,4,272.3
20,106,13,6,7,521.3
20,110,6,5,1,349.2
20,111,6,2,4,232.2
20,112,3,1,2,0
20,116,6,3,3,310.2
20,117,5,2,3,243
20,118,18,10,8,1045.8
20,119,66,33,33,3115.2
20,120,381,176,205,15163.8
20,121,38,17,21,1523.8
20,122,50,26,24,1680
20,123,49,23,26,1881.6
20,125,2,1,1,0
21,49,14,10,4,466.2
21,50,147,75,72,7011.9
21,51,6,1,5,237
21,70,2,2,0,0
21,71,2,1,1,0
21,79,3,2,1,0
21,80,7,3,4,275.1
21,86,39,23,16,1766.7
21,88,133,64,69,4987.5
21,92,3,2,1,0
21,93,8,4,4,307.2
21,100,35,16,19,1879.5
21,101,14,7,7,730.8
21,103,3,1,2,0
21,108,8,3,5,215.2
21,114,4,2,2,0
21,115,14,7,7,715.4
21,116,19,11,8,756.2
21,117,2,0,2,0
21,118,7,4,3,317.1
21,119,19,7,12,659.3
21,121,4,2,2,0
21,124,4,2,2,0
22,49,121,63,58,5166.7
22,50,188,101,87,7275.6
22,68,11,7,4,563.2
22,69,22,9,13,957
22,80,21,9,12,783.3
22,86,84,51,33,3763.2
22,87,12,6,6,536.4
22,88,101,52,49,4343
22,93,3,2,1,0
22,99,14,9,5,687.4
22,100,34,18,16,1740.8
22,102,1,1,0,0
22,103,38,17,21,1911.4
22,108,2,1,1,0
22,112,5,2,3,166
22,119,10,6,4,484
22,120,6,3,3,385.8
22,124,8,4,4,388
22,125,6,3,3,442.8
22,126,5,3,2,347
23,49,121,60,61,4767.4
23,50,45,24,21,1908
23,59,5,3,2,182
23,60,4,1,3,0
23,67,11,6,5,519.2
23,68,30,19,11,1407
23,69,72,39,33,3520.8
23,80,7,4,3,189
23,81,27,14,13,1031.4
23,85,30,15,15,729
23,86,176,86,90,7779.2
23,87,34,20,14,1771.4
23,88,90,41,49,3744
23,94,15,5,10,637.5
23,100,5,4,1,127
23,108,2,0,2,0
23,110,4,3,1,0
23,112,7,3,4,252.7
23,120,6,2,4,310.2
23,124,18,11,7,772.2
23,125,14,7,7,427
24,49,1,1,0,0
24,67,63,35,28,2608.2
24,68,32,18,14,1571.2
24,80,17,8,9,583.1
24,81,11,7,4,478.5
24,82,24,10,14,868.8
24,83,20,14,6,872
24,84,242,118,124,7816.6
24,85,769,395,374,30298.6
24,86,39,19,20,1903.2
24,87,131,69,62,5266.2
24,88,42,22,20,1541.4
24,89,9,6,3,330.3
24,94,24,14,10,1214.4
24,108,19,11,8,1005.1
24,120,3,2,1,0
24,124,9,6,3,455.4
24,125,19,9,10,866.4
25,48,12,6,6,489.6
25,49,11,5,6,601.7
25,67,11,6,5,524.7
25,81,24,14,10,1029.6
25,82,6,3,3,295.2
25,84,44,23,21,1403.6
25,85,527,261,266,21659.7
25,86,41,20,21,2074.6
25,87,92,43,49,3818
25,88,52,29,23,2761.2
25,89,1,1,0,0
25,94,11,7,4,563.2
25,95,5,3,2,103
25,108,10,6,4,543
25,124,5,3,2,180
25,125,1,1,0,0
26,48,13,9,4,575.9
26,49,2,1,1,0
26,57,2,1,1,0
26,66,22,10,12,836
26,81,4,2,2,0
26,85,34,14,20,1822.4
26,86,359,159,200,19888.6
26,87,172,84,88,6398.4
26,95,8,5,3,242.4
26,111,11,4,7,486.2
26,124,11,5,6,445.5
26,125,8,3,5,348
27,47,6,4,2,349.2
27,48,21,11,10,978.6
27,65,4,2,2,0
27,81,2,1,1,0
27,82,5,3,2,300
27,86,15,9,6,658.5
27,87,65,31,34,2964
27,111,10,6,4,536
27,124,11,7,4,553.3
27,125,49,26,23,1920.8
27,126,6,3,3,213
28,47,18,10,8,741.6
28,48,6,3,3,253.2
28,86,70,34,36,2786
28,87,13,7,6,549.9
28,95,1,1,0,0
28,96,4,3,1,0
28,109,6,3,3,256.8
28,125,15,9,6,685.5
28,126,3,1,2,0
28,127,15,8,7,570
29,46,10,4,6,388
29,47,12,6,6,561.6
29,86,14,7,7,649.6
29,96,2,2,0,0
29,108,17,7,10,748
29,109,10,6,4,351
29,124,3,2,1,0
29,125,9,3,6,545.4
29,126,1,1,0,0
30,46,13,6,7,429
30,86,13,5,8,553.8
30,87,1,1,0,0
30,125,14,7,7,555.8
31,45,3,2,1,0
31,46,2,1,1,0
31,64,5,2,3,145
31,86,4,1,3,0
31,87,47,26,21,1776.6
31,96,4,3,1,0
31,109,2,1,1,0
31,125,1,1,0,0
31,126,8,4,4,348
32,44,5,3,2,160
32,45,5,3,2,215
32,63,1,1,0,0
32,87,20,8,12,866
32,97,6,4,2,322.8
32,126,24,16,8,1005.6
33,32,5,1,4,162
33,43,1,1,0,0
33,44,6,2,4,228
33,87,27,13,14,1128.6
33,97,7,3,4,282.8
33,109,10,6,4,413
33,126,3,1,2,0
34,33,2,1,1,0
34,34,3,1,2,0
34,42,8,6,2,299.2
34,43,4,1,3,0
34,87,18,11,7,648
34,97,2,1,1,0
34,109,10,6,4,449
34,110,4,1,3,0
34,126,14,6,8,806.4
35,42,9,5,4,452.7
35,87,43,20,23,1732.9
35,109,44,21,23,1865.6
35,123,5,3,2,142
35,126,3,2,1,0
35,127,17,10,7,601.8
36,41,10,3,7,481
36,42,7,3,4,282.8
36,86,6,3,3,256.2
36,87,79,43,36,3144.2
36,88,6,2,4,276
36,109,29,13,16,1226.7
36,126,8,3,5,198.4
36,127,18,10,8,1036.8
37,33,1,1,0,0
37,40,1,1,0,0
37,87,39,20,19,1669.2
37,127,4,2,2,0
38,31,1,1,0,0
38,32,12,5,7,555.6
38,33,3,2,1,0
38,39,11,6,5,277.2
38,40,3,1,2,0
38,87,35,21,14,1092
38,88,4,3,1,0
38,109,5,4,1,223
39,34,8,3,5,358.4
39,38,7,3,4,293.3
39,39,19,10,9,685.9
39,87,14,7,7,634.2
39,88,11,6,5,435.6
39,109,11,6,5,500.5
39,110,2,1,1,0
40,35,3,2,1,0
40,37,13,6,7,526.5
40,38,4,2,2,0
40,87,17,9,8,698.7
40,88,21,11,10,1010.1
40,110,6,4,2,262.8
40,119,5,4,1,190
41,36,44,24,20,2169.2
41,37,38,18,20,1280.6
41,53,3,1,2,0
41,88,14,8,6,583.8
41,89,1,0,1,0
41,109,2,1,1,0
41,110,48,27,21,2121.6
42,39,3,2,1,0
42,53,6,3,3,409.8
42,88,10,6,4,498
42,89,12,9,3,550.8
42,110,97,49,48,3559.9
42,111,56,26,30,2553.6
42,116,1,1,0,0
42,117,2,1,1,0
42,122,7,5,2,310.1
43,39,5,3,2,371
43,89,31,17,14,1286.5
43,101,4,2,2,0
43,109,6,3,3,154.2
43,110,4,2,2,0
43,111,7,2,5,137.9
43,112,18,9,9,604.8
43,115,8,4,4,334.4
43,116,13,6,7,522.6
43,117,40,18,22,1668
44,40,3,2,1,0
44,51,6,4,2,319.8
44,89,58,31,27,2534.6
44,90,9,7,2,492.3
44,102,1,1,0,0
44,111,25,15,10,765
44,112,15,9,6,646.5
44,113,48,27,21,2112
44,114,3,2,1,0
44,118,23,10,13,706.1
44,124,6,3,3,328.8
44,125,5,2,3,158
44,126,11,8,3,491.7
45,40,2,1,1,0
45,89,28,14,14,1024.8
45,90,42,19,23,1902.6
45,91,2,1,1,0
45,110,11,6,5,522.5
45,111,7,2,5,287.7
45,112,1,0,1,0
45,113,9,4,5,349.2
45,114,7,4,3,394.1
45,118,19,10,9,868.3
45,119,39,17,22,1563.9
45,120,11,5,6,534.6
45,127,35,18,17,1071
46,40,7,3,4,258.3
46,90,14,9,5,376.6
46,91,29,16,13,1334
46,102,3,2,1,0
46,103,4,2,2,0
46,113,11,6,5,543.4
46,114,13,7,6,587.6
46,118,16,8,8,678.4
46,119,436,204,232,19838
46,120,269,137,132,10275.8
47,49,5,3,2,134
47,50,3,1,2,0
47,91,16,8,8,734.4
47,92,19,8,11,748.6
47,118,53,26,27,1913.3
47,119,586,284,302,26370
47,120,777,400,377,32634
47,121,339,169,170,12644.7
47,122,17,7,10,697
48,40,1,1,0,0
48,49,2,1,1,0
48,91,13,5,8,396.5
48,92,37,19,18,1705.7
48,118,49,27,22,2273.6
48,119,147,72,75,5806.5
48,121,10,4,6,394
48,122,37,19,18,1132.2
48,123,7,5,2,308.7
49,40,5,2,3,369
49,91,18,8,10,734.4
49,92,100,54,46,3940
49,93,6,3,3,229.2
49,114,3,2,1,0
49,119,11,5,6,443.3
49,120,7,3,4,280
49,123,17,8,9,547.4
49,124,5,2,3,288
49,125,22,12,10,767.8
49,126,12,6,6,307.2
50,39,1,1,0,0
50,91,88,46,42,3291.2
50,92,72,37,35,3225.6
50,93,87,40,47,3619.2
50,94,5,3,2,358
50,120,15,8,7,535.5
50,121,93,54,39,3441
50,124,17,8,9,540.6
50,125,4,2,2,0
50,126,13,9,4,600.6
51,44,9,6,3,343.8
51,48,11,4,7,360.8
51,90,4,3,1,0
51,91,21,11,10,630
51,92,246,108,138,12029.4
51,93,303,149,154,12726
51,94,43,24,19,1659.8
51,95,7,3,4,329
51,96,5,1,4,125
51,120,2,1,1,0
51,121,29,16,13,1084.6
51,122,8,3,5,208
51,127,6,5,1,268.8
52,42,3,1,2,0
52,43,3,2,1,0
52,44,3,3,0,0
52,46,2,1,1,0
52,91,16,11,5,675.2
52,92,66,25,41,3531
52,93,42,19,23,1675.8
52,94,17,5,12,566.1
52,95,7,5,2,359.1
52,96,4,2,2,0
52,97,13,6,7,544.7
52,120,17,9,8,873.8
52,121,2,1,1,0
53,38,11,6,5,478.5
53,39,10,7,3,461
53,40,61,28,33,2281.4
53,41,19,8,11,847.4
53,90,1,0,1,0
53,91,46,24,22,1683.6
53,96,7,3,4,242.9
53,97,38,19,19,1421.2
53,120,11,6,5,489.5
53,121,10,7,3,471
54,37,6,2,4,235.2
54,38,7,4,3,282.8
54,39,10,6,4,624
54,40,5,3,2,146
54,90,8,4,4,503.2
54,91,7,4,3,277.9
54,94,21,10,11,907.2
54,96,23,12,11,667
54,97,31,16,15,1261.7
54,111,2,1,1,0
54,123,10,4,6,306
55,37,7,4,3,247.8
55,39,3,2,1,0
55,89,18,8,10,819
55,90,2,1,1,0
55,94,10,5,5,506
55,95,3,1,2,0
55,96,1,0,1,0
55,97,30,18,12,1164
55,122,4,2,2,0
55,123,6,2,4,228
56,38,20,10,10,720
56,39,12,6,6,601.2
56,40,6,3,3,265.2
56,88,3,2,1,0
56,89,28,10,18,954.8
56,94,6,3,3,130.2
56,95,9,4,5,414
56,97,17,10,7,703.8
56,98,1,1,0,0
56,122,6,3,3,189
56,123,4,2,2,0
56,124,7,5,2,168.7
56,125,2,1,1,0
56,127,1,1,0,0
57,37,2,1,1,0
57,38,15,9,6,753
57,40,13,6,7,614.9
57,88,7,4,3,371
57,89,1,1,0,0
57,94,5,2,3,86
57,97,25,15,10,1030
57,98,5,3,2,330
57,101,4,3,1,0
57,124,7,5,2,280.7
57,125,72,36,36,3124.8
58,40,7,4,3,349.3
58,41,16,8,8,598.4
58,42,3,1,2,0
58,88,16,12,4,686.4
58,89,10,6,4,493
58,97,35,18,17,1340.5
58,98,3,1,2,0
58,99,7,4,3,347.9
58,100,30,16,14,1395
58,101,13,6,7,366.6
58,111,1,0,1,0
58,123,1,1,0,0
58,125,27,16,11,1293.3
58,126,10,5,5,233
59,42,20,11,9,732
59,43,3,1,2,0
59,87,8,4,4,284
59,88,1,1,0,0
59,97,14,8,6,554.4
59,100,5,2,3,196
59,101,20,10,10,664
59,109,5,3,2,343
59,125,4,3,1,0
59,126,26,13,13,1008.8
60,39,10,6,4,547
60,42,31,17,14,1292.7
60,43,28,14,14,974.4
60,97,27,16,11,980.1
60,99,8,4,4,500.8
60,110,3,2,1,0
60,111,6,2,4,247.2
61,39,1,1,0,0
61,40,3,2,1,0
61,42,69,36,33,3353.4
61,43,18,10,8,1018.8
61,44,1,0,1,0
61,87,8,3,5,360
61,97,26,17,9,1034.8
61,99,7,4,3,265.3
61,100,8,4,4,442.4
61,101,2,1,1,0
61,102,15,7,8,706.5
61,111,2,1,1,0
62,26,5,3,2,161
62,39,9,6,3,357.3
62,40,3,2,1,0
62,41,5,2,3,240
62,42,36,17,19,1573.2
62,43,7,4,3,207.2
62,45,4,1,3,0
62,87,17,10,7,724.2
62,96,14,7,7,716.8
62,97,5,3,2,271
62,100,12,7,5,531.6
62,102,13,4,9,440.7
62,103,6,4,2,244.8
62,111,5,2,3,186
62,126,4,2,2,0
63,27,6,2,4,211.8
63,39,12,6,6,418.8
63,42,45,27,18,2146.5
63,86,7,4,3,277.9
63,87,2,1,1,0
63,96,10,4,6,382
63,101,8,5,3,351.2
63,103,8,4,4,296.8
63,104,3,2,1,0
63,126,24,10,14,1046.4
64,7,3,1,2,0
64,25,7,4,3,217.7
64,27,27,15,12,1336.5
64,28,30,12,18,1140
64,29,2,1,1,0
64,38,1,0,1,0
64,39,6,4,2,292.2
64,40,13,8,5,553.8
64,41,5,2,3,315
64,42,29,16,13,1035.3
64,43,38,22,16,1550.4
64,44,5,3,2,200
64,96,7,3,4,261.8
64,101,6,4,2,210
64,104,11,4,7,545.6
64,111,4,1,3,0
64,124,13,8,5,612.3
64,126,1,0,1,0
64,127,2,1,1,0
65,22,2,1,1,0
65,28,11,8,3,519.2
65,29,12,6,6,505.2
65,30,8,5,3,364.8
65,32,10,5,5,297
65,33,3,2,1,0
65,40,17,7,10,474.3
65,42,71,35,36,2534.7
65,43,47,24,23,2185.5
65,44,12,7,5,481.2
65,45,6,3,3,88.2
65,55,3,2,1,0
65,96,1,1,0,0
65,97,2,1,1,0
65,105,6,2,4,238.2
65,106,3,3,0,0
65,111,1,1,0,0
65,123,10,5,5,434
65,124,21,15,6,722.4
66,21,9,4,5,340.2
66,30,11,7,4,304.7
66,31,19,10,9,887.3
66,32,29,12,17,1296.3
66,33,16,8,8,670.4
66,34,8,5,3,255.2
66,35,6,2,4,169.8
66,36,2,1,1,0
66,40,21,10,11,768.6
66,41,14,8,6,554.4
66,42,194,93,101,6596
66,43,17,8,9,613.7
66,59,5,2,3,328
66,96,4,2,2,0
66,104,2,1,1,0
66,105,4,2,2,0
66,106,1,1,0,0
67,31,8,6,2,244.8
67,32,29,12,17,1136.8
67,33,90,48,42,3222
67,34,1,0,1,0
67,35,22,12,10,972.4
67,36,44,20,24,1795.2
67,37,11,6,5,366.3
67,39,13,7,6,586.3
67,40,8,3,5,279.2
67,41,73,38,35,3146.3
67,42,8,4,4,251.2
67,59,25,14,11,1185
67,60,10,6,4,323
68,32,15,9,6,417
68,33,23,9,14,722.2
68,34,7,3,4,410.9
68,35,10,4,6,422
68,36,24,12,12,1120.8
68,37,18,10,8,552.6
68,38,22,9,13,897.6
68,39,14,7,7,289.8
68,40,1,0,1,0
68,41,40,19,21,1528
68,59,13,7,6,570.7
68,60,29,19,10,1293.4
68,96,3,2,1,0
68,102,4,2,2,0
68,103,10,5,5,510
68,104,4,2,2,0
69,35,10,5,5,334
69,36,17,11,6,666.4
69,37,34,21,13,1343
69,38,18,9,9,885.6
69,39,54,32,22,2181.6
69,40,83,42,41,3552.4
69,41,49,26,23,2067.8
69,60,1,1,0,0
69,61,22,12,10,1047.2
69,95,1,1,0,0
69,96,7,3,4,315
69,103,9,5,4,425.7
69,105,13,6,7,548.6
70,37,29,18,11,1122.3
70,38,571,292,279,20384.7
70,39,1040,517,523,45448
70,40,277,138,139,10609.1
70,41,10,4,6,246
70,61,22,11,11,827.2
70,95,6,3,3,259.8
70,96,18,9,9,714.6
70,103,11,6,5,491.7
70,104,2,1,1,0
70,107,4,2,2,0
70,108,9,4,5,450
70,109,2,1,1,0
70,111,3,2,1,0
71,38,11,7,4,359.7
71,39,842,407,435,37216.4
71,40,688,320,368,33505.6
71,61,2,1,1,0
71,62,8,4,4,347.2
71,92,15,9,6,574.5
71,93,31,11,20,1413.6
71,94,33,16,17,1389.3
71,95,312,162,150,13572
71,96,24,15,9,1171.2
71,97,27,14,13,675
71,98,8,4,4,280
71,103,3,2,1,0
71,104,5,3,2,155
71,105,9,4,5,325.8
71,106,34,21,13,1047.2
71,107,17,9,8,790.5
71,109,10,6,4,428
71,110,4,1,3,0
71,114,2,1,1,0
71,115,12,7,5,531.6
72,39,272,134,138,9764.8
72,40,531,269,262,21080.7
72,41,13,6,7,435.5
72,91,22,12,10,893.2
72,92,10,7,3,490
72,93,41,18,23,1750.7
72,94,15,8,7,621
72,95,18,8,10,559.8
72,97,28,12,16,921.2
72,98,70,31,39,3045
72,99,19,9,10,834.1
72,105,11,6,5,508.2
72,106,28,15,13,994
72,107,15,8,7,556.5
72,109,8,6,2,292
72,111,11,7,4,407
72,112,6,3,3,349.2
72,115,8,5,3,370.4
72,124,4,2,2,0
72,125,12,7,5,507.6
73,40,35,20,15,1221.5
73,41,44,20,24,2147.2
73,91,28,14,14,1369.2
73,92,6,5,1,187.8
73,94,7,5,2,398.3
73,96,3,1,2,0
73,98,2,1,1,0
73,99,15,10,5,640.5
73,100,7,3,4,265.3
73,107,27,16,11,764.1
73,111,1,1,0,0
73,112,3,1,2,0
73,113,7,5,2,217
73,115,6,3,3,205.8
73,116,27,16,11,869.4
73,117,6,3,3,316.2
73,118,4,2,2,0
73,125,6,4,2,304.8
73,126,6,3,3,192
74,40,12,7,5,417.6
74,41,32,15,17,1337.6
74,42,28,15,13,1405.6
74,81,1,0,1,0
74,90,9,4,5,248.4
74,99,7,4,3,214.2
74,100,1,1,0,0
74,101,7,4,3,373.1
74,102,19,9,10,1012.7
74,107,25,13,12,895
74,109,23,11,12,715.3
74,111,2,2,0,0
74,116,4,1,3,0
74,117,15,10,5,786
75,39,5,3,2,153
75,40,9,5,4,352.8
75,41,1,1,0,0
75,42,29,14,15,1220.9
75,43,7,5,2,312.2
75,68,6,4,2,100.8
75,81,2,1,1,0
75,88,19,13,6,913.9
75,89,5,3,2,164
75,90,39,20,19,1680.9
75,91,6,2,4,217.2
75,96,14,9,5,565.6
75,98,12,5,7,338.4
75,99,305,159,146,11285
75,102,9,5,4,434.7
75,106,2,1,1,0
75,107,4,2,2,0
75,110,14,9,5,413
75,111,9,5,4,260.1
75,116,12,7,5,519.6
75,117,12,6,6,600
75,118,7,5,2,448
75,119,2,1,1,0
76,40,1,1,0,0
76,42,6,4,2,148.8
76,43,45,20,25,1845
76,44,25,12,13,707.5
76,75,3,2,1,0
76,76,5,1,4,213
76,81,7,4,3,329
76,82,16,9,7,886.4
76,83,2,1,1,0
76,84,9,4,5,482.4
76,85,14,6,8,723.8
76,86,22,12,10,1089
76,87,37,18,19,1317.2
76,88,29,17,12,1087.5
76,89,169,77,92,7588.1
76,90,311,152,159,13621.8
76,91,4,2,2,0
76,93,6,3,3,174
76,94,78,41,37,2823.6
76,95,90,47,43,3753
76,96,165,81,84,7870.5
76,97,142,68,74,6617.2
76,98,85,46,39,3034.5
76,99,3,2,1,0
76,102,10,4,6,422
76,112,14,8,6,680.4
76,114,4,1,3,0
76,115,4,2,2,0
76,116,1,1,0,0
76,117,12,7,5,398.4
76,118,4,2,2,0
76,121,2,1,1,0
77,42,1,1,0,0
77,43,2,1,1,0
77,44,13,7,6,504.4
77,75,20,10,10,1036
77,76,7,3,4,300.3
77,81,4,2,2,0
77,82,106,55,51,4515.6
77,83,103,58,45,4161.2
77,84,11,5,6,390.5
77,85,12,6,6,492
77,86,30,11,19,1116
77,87,13,8,5,460.2
77,88,67,33,34,2740.3
77,89,144,59,85,8697.6
77,90,6,2,4,237
77,94,11,3,8,347.6
77,96,6,3,3,252
77,97,14,6,8,642.6
77,98,222,110,112,9102
77,99,238,121,117,9758
77,100,114,61,53,4229.4
77,101,24,13,11,931.2
77,102,7,4,3,447.3
77,103,2,1,1,0
77,106,6,3,3,258
77,114,26,14,12,1001
77,115,9,6,3,312.3
78,42,5,2,3,132
78,44,8,3,5,248
78,46,6,4,2,274.8
78,74,7,2,5,368.2
78,75,16,8,8,862.4
78,76,16,8,8,606.4
78,77,13,7,6,598
78,78,3,2,1,0
78,79,10,6,4,291
78,81,5,3,2,371
78,82,79,38,41,3349.6
78,83,129,63,66,5843.7
78,84,21,12,9,909.3
78,85,8,3,5,564.8
78,86,13,7,6,504.4
78,101,17,6,11,693.6
78,102,12,7,5,499.2
78,103,45,24,21,1876.5
78,106,20,11,9,850
78,114,6,2,4,211.2
78,115,10,7,3,506
78,116,19,14,5,446.5
79,43,2,0,2,0
79,44,1,0,1,0
79,46,1,1,0,0
79,73,1,1,0,0
79,74,17,10,7,748
79,75,2,1,1,0
79,76,6,5,1,274.2
79,77,3,2,1,0
79,78,8,4,4,367.2
79,79,10,7,3,445
79,80,27,18,9,1090.8
79,81,2,2,0,0
79,82,64,30,34,2342.4
79,83,3,1,2,0
79,93,1,0,1,0
79,96,5,3,2,203
79,102,49,27,22,1842.4
79,103,250,123,127,9625
79,104,26,13,13,1006.2
79,105,4,3,1,0
79,106,41,21,20,1484.2
79,111,17,10,7,652.8
79,112,23,14,9,788.9
79,114,3,2,1,0
79,115,20,8,12,920
79,116,8,4,4,287.2
79,117,15,9,6,489
80,42,1,1,0,0
80,45,2,1,1,0
80,46,19,10,9,672.6
80,67,2,1,1,0
80,68,8,5,3,291.2
80,69,3,2,1,0
80,70,1,1,0,0
80,71,5,2,3,213
80,72,16,8,8,844.8
80,73,29,15,14,1197.7
80,74,1,1,0,0
80,79,4,2,2,0
80,80,5,3,2,204
80,81,1,0,1,0
80,95,2,1,1,0
80,101,18,8,10,558
80,102,56,28,28,1993.6
80,103,34,17,17,1224
80,104,41,22,19,1447.3
80,105,42,20,22,1600.2
80,106,178,91,87,7191.2
80,108,31,13,18,936.2
80,109,19,11,8,577.6
80,110,26,13,13,933.4
80,111,19,9,10,632.7
80,112,31,14,17,1395
80,113,8,5,3,360.8
80,114,19,11,8,915.8
80,115,33,15,18,1386
80,117,3,1,2,0
81,45,49,25,24,1514.1
81,46,34,17,17,1526.6
81,47,4,3,1,0
81,53,2,1,1,0
81,67,49,27,22,2366.7
81,68,46,24,22,1619.2
81,69,14,7,7,795.2
81,70,101,49,52,5029.8
81,71,54,28,26,2219.4
81,72,7,3,4,238
81,103,16,10,6,606.4
81,104,4,4,0,0
81,106,179,90,89,5781.7
81,107,62,33,29,2542
81,108,64,35,29,2163.2
81,109,52,29,23,1898
81,110,15,6,9,694.5
81,111,31,18,13,1227.6
81,112,74,36,38,3026.6
81,113,68,30,38,2754
81,114,17,9,8,627.3
81,115,31,16,15,1320.6
81,118,6,2,4,187.8
82,45,11,6,5,393.8
82,46,7,4,3,270.2
82,53,11,6,5,510.4
82,67,80,43,37,3544
82,69,12,8,4,464.4
82,70,8,3,5,314.4
82,95,2,1,1,0
82,100,3,1,2,0
82,105,22,13,9,774.4
82,106,17,12,5,593.3
82,107,53,26,27,1934.5
82,108,49,28,21,1773.8
82,109,15,10,5,658.5
82,111,62,30,32,2256.8
82,112,96,47,49,3100.8
82,113,139,66,73,5351.5
82,114,14,8,6,777
82,115,68,37,31,2890
82,116,6,3,3,271.2
82,118,22,10,12,803
83,47,7,3,4,263.2
83,48,5,4,1,324
83,49,4,3,1,0
83,50,6,2,4,216
83,54,2,1,1,0
83,65,9,5,4,214.2
83,66,42,25,17,1827
83,67,14,6,8,553
83,94,3,1,2,0
83,99,6,3,3,159
83,103,1,1,0,0
83,105,15,8,7,579
83,106,46,26,20,1545.6
83,107,10,5,5,323
83,111,16,7,9,633.6
83,112,110,61,49,3828
83,113,300,146,154,12180
83,114,50,23,27,1775
83,115,22,12,10,877.8
83,116,6,3,3,268.2
83,118,23,11,12,899.3
83,119,32,15,17,1148.8
84,48,12,6,6,549.6
84,49,6,4,2,376.8
84,50,8,4,4,404
84,51,4,1,3,0
84,65,9,5,4,404.1
84,66,29,14,15,1113.6
84,67,9,4,5,372.6
84,103,2,0,2,0
84,106,14,6,8,536.2
84,111,4,1,3,0
84,112,13,9,4,443.3
84,113,775,337,438,36425
84,114,844,427,417,32240.8
84,115,137,70,67,5480
84,116,53,28,25,2019.3
84,117,2,2,0,0
84,118,159,84,75,5199.3
84,119,451,220,231,16236
84,120,7,6,1,254.1
85,49,1,1,0,0
85,50,15,8,7,607.5
85,51,4,2,2,0
85,53,5,2,3,182
85,54,1,0,1,0
85,65,19,8,11,733.4
85,66,11,4,7,563.2
85,92,1,1,0,0
85,104,12,6,6,450
85,112,68,33,35,2502.4
85,113,70,41,29,2429
85,114,14,8,6,422.8
85,115,754,364,390,29330.6
85,116,743,357,386,32246.2
85,117,786,375,411,37335
85,118,128,70,58,5619.2
85,120,3,2,1,0
85,124,2,1,1,0
86,49,1,1,0,0
86,50,2,1,1,0
86,51,19,10,9,868.3
86,55,16,11,5,569.6
86,56,3,1,2,0
86,65,8,4,4,308.8
86,104,3,1,2,0
86,105,2,2,0,0
86,112,8,4,4,222.4
86,115,71,38,33,2456.6
86,116,117,62,55,4492.8
86,117,972,510,462,39074.4
86,118,1757,870,887,69577.2
86,121,8,4,4,316
86,124,3,2,1,0
87,49,10,4,6,325
87,50,8,5,3,251.2
87,53,1,1,0,0
87,54,25,14,11,1302.5
87,55,32,15,17,1129.6
87,56,25,10,15,985
87,57,21,10,11,1026.9
87,58,11,6,5,630.3
87,59,4,2,2,0
87,64,1,1,0,0
87,94,15,9,6,634.5
87,99,2,2,0,0
87,100,1,0,1,0
87,118,11,6,5,386.1
87,121,8,5,3,252.8
87,122,6,3,3,183
87,124,10,6,4,536
88,50,3,1,2,0
88,51,8,5,3,343.2
88,54,15,8,7,640.5
88,55,9,4,5,457.2
88,56,1,1,0,0
88,57,1,1,0,0
88,59,5,2,3,153
88,60,7,5,2,382.9
88,61,5,2,3,187
88,64,17,10,7,411.4
88,65,17,8,9,673.2
88,93,2,1,1,0
88,94,1,1,0,0
88,95,16,10,6,505.6
88,96,12,7,5,612
88,97,11,6,5,324.5
88,98,5,2,3,280
88,99,2,1,1,0
88,100,5,4,1,315
88,122,26,13,13,1552.2
88,124,25,13,12,952.5
89,47,11,5,6,336.6
89,50,7,4,3,340.9
89,51,25,10,15,752.5
89,52,15,10,5,676.5
89,55,5,2,3,115
89,56,1,1,0,0
89,60,3,1,2,0
89,61,1,1,0,0
89,63,59,30,29,2472.1
89,64,286,151,135,14157
89,65,211,96,115,10761
89,97,13,6,7,416
89,98,4,2,2,0
89,111,4,2,2,0
89,122,9,5,4,357.3
89,123,6,3,3,384
89,124,18,8,10,732.6
90,47,2,1,1,0
90,49,3,0,3,0
90,50,15,9,6,742.5
90,51,55,27,28,2029.5
90,52,15,8,7,820.5
90,60,2,2,0,0
90,61,8,4,4,472
90,62,9,4,5,440.1
90,63,214,98,116,7960.8
90,64,147,73,74,6262.2
90,65,78,41,37,3868.8
90,66,1,1,0,0
90,67,3,1,2,0
90,68,4,2,2,0
90,94,10,5,5,518
90,95,13,5,8,408.2
90,96,81,42,39,3474.9
90,97,23,11,12,977.5
90,98,13,4,9,422.5
90,99,32,20,12,1020.8
90,112,6,2,4,237
90,120,4,2,2,0
90,123,6,3,3,418.2
90,124,37,20,17,1494.8
91,47,6,1,5,132
91,51,4,2,2,0
91,61,2,1,1,0
91,62,17,8,9,666.4
91,63,4,3,1,0
91,64,2,1,1,0
91,67,3,2,1,0
91,68,6,3,3,262.2
91,69,1,0,1,0
91,93,4,2,2,0
91,94,26,13,13,1037.4
91,95,13,8,5,452.4
91,96,57,26,31,2673.3
91,97,10,5,5,480
91,98,1,1,0,0
91,99,14,8,6,592.2
91,109,11,5,6,470.8
91,110,17,8,9,690.2
91,111,30,17,13,1053
91,112,67,35,32,2505.8
91,118,2,1,1,0
91,121,13,7,6,536.9
91,125,14,10,4,567
92,61,6,4,2,121.2
92,63,1,0,1,0
92,68,19,10,9,653.6
92,69,10,5,5,407
92,92,6,3,3,184.2
92,93,22,12,10,807.4
92,95,32,20,12,1376
92,96,18,8,10,669.6
92,99,14,8,6,480.2
92,100,11,7,4,479.6
92,109,36,19,17,1033.2
92,110,49,22,27,1715
92,111,19,10,9,722
92,112,99,52,47,4098.6
92,113,35,21,14,1487.5
92,119,26,12,14,1073.8
92,120,1,1,0,0
92,121,69,34,35,2504.7
92,122,98,47,51,3292.8
93,61,1,1,0,0
93,67,9,6,3,347.4
93,68,14,5,9,548.8
93,69,4,2,2,0
93,92,2,1,1,0
93,93,5,3,2,189
93,94,8,4,4,152
93,95,6,4,2,181.2
93,96,4,3,1,0
93,98,7,3,4,235.9
93,100,14,6,8,418.6
93,101,11,6,5,474.1
93,108,3,2,1,0
93,109,5,2,3,222
93,110,25,16,9,875
93,112,31,18,13,1413.6
93,113,29,16,13,1339.8
93,114,3,2,1,0
93,119,3,2,1,0
93,120,17,9,8,722.5
93,121,219,115,104,8037.3
93,122,39,18,21,1513.2
94,32,1,1,0,0
94,50,5,2,3,240
94,67,18,12,6,678.6
94,68,3,2,1,0
94,69,18,9,9,822.6
94,91,6,3,3,211.8
94,92,4,3,1,0
94,93,15,5,10,489
94,94,23,15,8,977.5
94,96,3,2,1,0
94,97,2,1,1,0
94,99,2,2,0,0
94,101,2,1,1,0
94,102,17,10,7,627.3
94,107,17,9,8,618.8
94,108,62,35,27,2399.4
94,109,24,12,12,784.8
94,110,29,15,14,1061.4
94,111,29,15,14,901.9
94,112,2,1,1,0
94,113,15,9,6,634.5
94,114,9,4,5,449.1
94,119,21,12,9,625.8
94,120,25,13,12,972.5
94,121,39,21,18,1462.5
95,47,9,4,5,279
95,49,2,1,1,0
95,50,5,2,3,241
95,69,15,6,9,526.5
95,70,18,11,7,817.2
95,71,4,2,2,0
95,72,1,0,1,0
95,92,28,12,16,1108.8
95,94,7,4,3,186.9
95,96,1,1,0,0
95,97,11,6,5,305.8
95,98,3,2,1,0
95,100,8,6,2,379.2
95,101,5,2,3,167
95,102,8,2,6,210.4
95,103,8,6,2,387.2
95,107,3,2,1,0
95,108,6,3,3,205.8
95,109,20,9,11,954
95,110,125,64,61,4950
95,111,107,57,50,5082.5
95,112,84,41,43,2839.2
95,113,11,7,4,312.4
95,114,276,154,122,10515.6
95,115,50,21,29,2020
95,116,10,6,4,268
95,119,435,232,203,12223.5
95,120,17,9,8,783.7
95,121,56,32,24,2105.6
95,122,4,1,3,0
96,72,22,10,12,926.2
96,73,9,4,5,378.9
96,74,3,2,1,0
96,92,4,2,2,0
96,93,3,2,1,0
96,97,46,24,22,1462.8
96,98,23,16,7,802.7
96,101,1,1,0,0
96,102,3,1,2,0
96,103,4,1,3,0
96,110,27,18,9,831.6
96,111,63,31,32,2526.3
96,112,72,35,37,2678.4
96,113,36,19,17,1170
96,114,14,7,7,428.4
96,115,43,24,19,1892
96,116,36,21,15,1306.8
96,117,8,4,4,460.8
96,118,39,24,15,1649.7
96,119,315,148,167,11623.5
96,120,428,227,201,15921.6
96,121,30,13,17,969
97,43,8,4,4,348.8
97,44,2,1,1,0
97,72,26,14,12,832
97,73,13,7,6,601.9
97,74,35,18,17,1386
97,93,5,3,2,324
97,97,12,6,6,537.6
97,98,30,16,14,1107
97,99,20,12,8,1030
97,100,152,75,77,8071.2
97,101,350,184,166,12810
97,102,6,3,3,220.8
97,108,4,2,2,0
97,111,5,2,3,175
97,114,6,2,4,243
97,115,11,5,6,498.3
97,116,20,11,9,764
97,117,40,22,18,1700
97,118,64,31,33,2572.8
97,119,350,159,191,17255
97,120,109,60,49,4621.6
97,124,7,4,3,328.3
97,125,39,22,17,1739.4
97,126,14,8,6,603.4
97,127,78,41,37,3003
98,42,13,6,7,600.6
98,43,2,1,1,0
98,68,4,2,2,0
98,74,2,1,1,0
98,75,35,13,22,1200.5
98,93,4,1,3,0
98,94,10,3,7,572
98,99,3,1,2,0
98,101,12,7,5,364.8
98,102,101,54,47,4130.9
98,103,40,20,20,1704
98,107,9,4,5,358.2
98,108,35,16,19,1067.5
98,109,4,3,1,0
98,115,45,23,22,1476
98,118,36,18,18,1468.8
98,119,6,3,3,204
98,124,70,37,33,2688
98,125,16,9,7,819.2
98,126,21,11,10,1092
98,127,14,6,8,562.8
99,40,12,6,6,496.8
99,42,7,3,4,415.1
99,59,6,3,3,243
99,61,1,1,0,0
99,65,3,2,1,0
99,68,2,1,1,0
99,69,3,2,1,0
99,75,36,18,18,1465.2
99,76,129,65,64,4656.9
99,77,70,33,37,2989
99,78,39,22,17,1805.7
99,79,24,14,10,897.6
99,85,2,1,1,0
99,98,2,1,1,0
99,99,6,4,2,166.8
99,100,4,4,0,0
99,103,20,11,9,946
99,104,7,3,4,205.8
99,105,10,5,5,560
99,106,4,2,2,0
99,107,17,8,9,639.2
99,108,55,28,27,2183.5
99,109,6,3,3,285
99,118,4,3,1,0
99,122,35,14,21,1470
99,123,30,16,14,1476
99,124,39,21,18,1509.3
99,125,10,6,4,212
99,126,14,9,5,474.6
99,127,2,2,0,0
100,37,27,14,13,1090.8
100,38,5,2,3,270
100,39,59,29,30,2377.7
100,40,9,4,5,447.3
100,70,14,6,8,536.2
100,73,20,10,10,992
100,74,53,26,27,1966.3
100,75,42,23,19,1596
100,76,101,53,48,4130.9
100,77,111,50,61,5139.3
100,78,8,5,3,384.8
100,79,23,10,13,1062.6
100,80,25,13,12,755
100,94,4,2,2,0
100,100,20,8,12,766
100,101,6,2,4,277.8
100,105,2,1,1,0
100,109,4,3,1,0
100,116,409,216,193,13128.9
100,117,187,92,95,5572.6
100,118,101,52,49,3737
100,122,48,24,24,1804.8
100,123,26,15,11,1118
100,124,22,11,11,708.4
100,125,17,9,8,822.8
100,126,29,16,13,1220.9
101,35,12,6,6,367.2
101,36,8,3,5,211.2
101,37,10,7,3,432
101,38,2,1,1,0
101,65,1,1,0,0
101,66,4,2,2,0
101,67,7,4,3,265.3
101,70,4,1,3,0
101,71,12,5,7,326.4
101,72,4,2,2,0
101,73,16,9,7,542.4
101,74,23,13,10,811.9
101,75,93,52,41,3887.4
101,76,27,16,11,1017.9
101,77,17,10,7,771.8
101,78,37,16,21,1080.4
101,80,1,1,0,0
101,93,9,4,5,381.6
101,94,38,20,18,1356.6
101,98,6,3,3,319.8
101,99,20,8,12,846
101,100,6,4,2,244.2
101,104,12,7,5,410.4
101,109,33,15,18,1122
101,110,61,28,33,2616.9
101,111,3,2,1,0
101,112,13,5,8,456.3
101,115,106,54,52,3551
101,116,400,203,197,11840
101,117,556,290,266,18014.4
101,118,19,8,11,672.6
101,121,35,22,13,1459.5
101,122,74,36,38,2353.2
101,123,35,18,17,1305.5
101,124,33,18,15,1188
101,125,8,5,3,264
101,126,6,2,4,229.2
101,127,7,4,3,364
102,34,28,11,17,890.4
102,35,17,7,10,572.9
102,60,2,1,1,0
102,63,8,3,5,303.2
102,64,4,2,2,0
102,65,5,1,4,131
102,66,6,4,2,384
102,67,5,3,2,167
102,68,4,2,2,0
102,69,14,6,8,474.6
102,70,20,9,11,874
102,71,38,21,17,1257.8
102,72,23,10,13,1124.7
102,73,24,10,14,1104
102,74,16,8,8,691.2
102,75,13,8,5,634.4
102,78,14,11,3,628.6
102,79,7,4,3,366.1
102,80,6,4,2,349.2
102,81,22,10,12,796.4
102,82,17,8,9,717.4
102,83,5,3,2,144
102,93,23,12,11,949.9
102,94,164,86,78,6625.6
102,95,40,22,18,1248
102,96,14,8,6,481.6
102,110,18,9,9,687.6
102,111,43,25,18,1440.5
102,112,105,56,49,4032
102,113,29,14,15,1200.6
102,114,55,31,24,2601.5
102,115,16,8,8,948.8
102,116,37,16,21,1635.4
102,117,574,284,290,21926.8
102,121,155,84,71,5843.5
102,122,490,221,269,19894
102,123,37,20,17,1476.3
102,124,89,38,51,3123.9
102,125,88,41,47,3977.6
102,126,49,24,25,1881.6
102,127,22,12,10,948.2
103,33,44,21,23,2411.2
103,34,10,6,4,552
103,35,3,2,1,0
103,59,2,1,1,0
103,61,5,3,2,147
103,62,2,2,0,0
103,64,1,0,1,0
103,68,4,3,1,0
103,69,23,11,12,1110.9
103,70,4,3,1,0
103,71,4,2,2,0
103,79,7,5,2,126.7
103,80,18,10,8,667.8
103,81,36,23,13,1256.4
103,82,5,4,1,256
103,83,12,2,10,436.8
103,84,16,10,6,688
103,85,22,6,16,798.6
103,91,24,16,8,1034.4
103,92,64,31,33,2579.2
103,93,94,45,49,3515.6
103,94,470,241,229,15416
103,95,148,79,69,5786.8
103,96,49,26,23,1911
103,97,61,31,30,2525.4
103,103,1,1,0,0
103,111,109,60,49,3640.6
103,112,26,15,11,1159.6
103,113,6,3,3,151.2
103,114,23,11,12,752.1
103,115,36,18,18,1598.4
103,116,90,46,44,3528
103,117,330,177,153,13893
103,118,181,90,91,6823.7
103,121,34,21,13,1485.8
103,122,47,23,24,1621.5
103,123,37,17,20,1598.4
103,124,9,3,6,228.6
104,23,4,2,2,0
104,30,4,1,3,0
104,31,1,1,0,0
104,32,18,9,9,754.2
104,33,68,30,38,2842.4
104,34,6,3,3,358.8
104,68,6,2,4,139.2
104,69,2,1,1,0
104,76,8,3,5,204
104,77,29,14,15,1244.1
104,78,7,4,3,200.9
104,81,38,19,19,1489.6
104,85,34,18,16,1438.2
104,86,135,70,65,5386.5
104,90,27,13,14,982.8
104,91,28,16,12,1187.2
104,92,44,22,22,2072.4
104,93,12,8,4,486
104,94,53,26,27,1701.3
104,95,30,19,11,1200
104,96,39,25,14,1766.7
104,97,99,33,66,6652.8
104,98,19,10,9,723.9
104,104,2,1,1,0
104,107,12,5,7,348
104,108,19,10,9,628.9
104,109,15,7,8,367.5
104,110,7,3,4,266
104,111,78,41,37,2558.4
104,112,199,97,102,6387.9
104,113,49,26,23,1974.7
104,114,13,7,6,527.8
104,115,16,9,7,860.8
104,116,25,16,9,855
104,117,12,6,6,337.2
104,118,29,14,15,1186.1
104,119,15,6,9,658.5
104,121,32,17,15,1152
105,27,2,2,0,0
105,28,1,0,1,0
105,30,1,1,0,0
105,31,10,5,5,279
105,32,16,8,8,617.6
105,33,2,1,1,0
105,73,4,1,3,0
105,75,5,2,3,89
105,77,12,5,7,456
105,78,2,1,1,0
105,79,4,3,1,0
105,80,1,0,1,0
105,84,2,2,0,0
105,85,92,45,47,3919.2
105,86,846,392,454,37054.8
105,87,261,129,132,9448.2
105,88,212,100,112,7886.4
105,89,27,13,14,885.6
105,90,29,15,14,1067.2
105,92,2,0,2,0
105,96,33,13,20,933.9
105,97,51,28,23,2136.9
105,98,138,70,68,5823.6
105,99,14,8,6,516.6
105,100,4,2,2,0
105,104,60,26,34,1890
105,105,106,52,54,3646.4
105,106,76,39,37,3085.6
105,107,33,17,16,1366.2
105,108,54,29,25,2214
105,109,10,6,4,586
105,110,12,7,5,658.8
105,111,45,20,25,1296
105,112,1007,501,506,30411.4
105,113,947,482,465,35701.9
105,114,116,60,56,4268.8
105,115,139,79,60,5254.2
105,116,54,28,26,1555.2
105,117,8,4,4,326.4
105,118,77,53,24,2910.6
105,119,29,16,13,974.4
105,120,16,9,7,884.8
105,121,36,17,19,1177.2
106,14,2,1,1,0
106,18,2,0,2,0
106,19,13,9,4,460.2
106,20,1,0,1,0
106,21,4,2,2,0
106,23,6,4,2,369
106,24,5,2,3,152
106,25,5,3,2,267
106,26,9,5,4,411.3
106,72,24,14,10,885.6
106,73,10,5,5,358
106,74,32,14,18,1132.8
106,75,3,1,2,0
106,76,15,8,7,585
106,85,49,28,21,1572.9
106,86,678,347,331,24950.4
106,87,44,22,22,1557.6
106,89,9,4,5,398.7
106,97,32,20,12,1004.8
106,98,510,279,231,19482
106,99,174,81,93,8508.6
106,100,16,8,8,569.6
106,101,31,16,15,1348.5
106,102,9,6,3,394.2
106,104,52,31,21,1710.8
106,105,35,19,16,1557.5
106,106,72,32,40,2512.8
106,107,173,85,88,5778.2
106,108,45,27,18,1854
106,109,31,14,17,1267.9
106,110,17,9,8,571.2
106,111,11,6,5,524.7
106,112,34,16,18,1336.2
106,113,294,146,148,9996
106,114,607,310,297,24037.2
106,115,231,119,112,8916.6
106,116,145,70,75,4393.5
106,117,48,26,22,1910.4
106,118,43,22,21,1853.3
106,120,54,26,28,1992.6
106,121,275,136,139,10642.5
106,122,163,83,80,5851.7
107,15,2,0,2,0
107,16,6,3,3,163.8
107,18,3,2,1,0
107,21,4,3,1,0
107,70,10,7,3,204
107,71,2,1,1,0
107,72,5,3,2,160
107,73,4,3,1,0
107,75,23,16,7,791.2
107,76,8,3,5,312.8
107,78,9,5,4,272.7
107,83,1,1,0,0
107,84,24,12,12,813.6
107,85,83,45,38,2971.4
107,86,5,3,2,192
107,97,4,2,2,0
107,98,69,36,33,3318.9
107,99,245,123,122,8820
107,100,71,41,30,2705.1
107,101,13,6,7,483.6
107,102,8,4,4,343.2
107,103,59,30,29,2454.4
107,104,159,79,80,5755.8
107,105,16,10,6,692.8
107,106,27,12,15,1080
107,107,75,44,31,3435
107,108,361,183,178,13718
107,109,12,7,5,333.6
107,110,12,7,5,471.6
107,111,158,74,84,5798.6
107,112,120,55,65,4932
107,113,161,77,84,7245
107,114,908,383,525,51574.4
107,115,341,174,167,13094.4
107,116,38,21,17,1603.6
107,117,31,16,15,812.2
107,118,14,10,4,596.4
107,119,12,6,6,397.2
107,120,59,35,24,2212.5
107,121,78,43,35,3393
107,122,18,10,8,862.2
107,125,5,2,3,228
108,13,10,5,5,520
108,14,4,3,1,0
108,15,2,1,1,0
108,18,12,7,5,511.2
108,32,3,1,2,0
108,62,2,1,1,0
108,66,6,2,4,289.2
108,67,3,2,1,0
108,68,10,5,5,305
108,70,2,1,1,0
108,71,31,17,14,1147
108,72,5,1,4,259
108,73,16,10,6,476.8
108,74,22,8,14,864.6
108,75,18,8,10,910.8
108,77,5,2,3,327
108,83,6,3,3,253.2
108,84,11,7,4,668.8
108,96,4,2,2,0
108,97,25,14,11,1190
108,98,41,22,19,1648.2
108,100,51,27,24,1785
108,101,55,25,30,1848
108,102,66,35,31,2508
108,103,135,67,68,5454
108,104,355,173,182,13454.5
108,105,32,18,14,1248
108,106,47,25,22,2039.8
108,107,16,11,5,684.8
108,112,188,95,93,7219.2
108,113,433,206,227,15284.9
108,114,136,69,67,5181.6
108,115,65,36,29,2483
108,116,42,20,22,1772.4
108,117,20,12,8,812
108,118,107,53,54,4108.8
108,119,75,37,38,3915
108,120,29,13,16,1107.8
108,121,91,48,43,3594.5
108,122,23,14,9,1007.4
108,126,21,11,10,751.8
108,127,12,7,5,573.6
109,4,2,1,1,0
109,14,16,9,7,609.6
109,68,3,1,2,0
109,71,12,7,5,423.6
109,74,4,2,2,0
109,83,13,7,6,520
109,97,4,3,1,0
109,101,10,5,5,532
109,102,11,6,5,547.8
109,103,42,24,18,1545.6
109,104,8,4,4,234.4
109,105,25,12,13,937.5
109,113,97,47,50,3356.2
109,114,638,316,322,20671.2
109,115,22,11,11,957
109,116,44,25,19,1394.8
109,117,25,14,11,1085
109,118,510,248,262,16728
109,119,180,89,91,5058
109,120,25,11,14,952.5
109,121,174,91,83,6316.2
109,123,66,33,33,2686.2
109,124,17,11,6,683.4
109,125,20,9,11,810
109,126,301,147,154,11377.8
109,127,55,31,24,2255
110,4,1,1,0,0
110,71,24,13,11,1084.8
110,83,11,5,6,535.7
110,84,4,3,1,0
110,102,26,15,11,1016.6
110,103,73,44,29,2540.4
110,104,78,42,36,2683.2
110,105,22,12,10,679.8
110,114,233,120,113,6244.4
110,115,108,58,50,3758.4
110,116,74,36,38,2671.4
110,117,47,23,24,1861.2
110,118,107,60,47,3798.5
110,119,29,15,14,1476.1
110,120,3367,1591,1776,126935.9
110,121,2783,1428,1355,102414.4
110,122,111,57,54,4528.8
110,123,523,270,253,20030.9
110,124,1766,900,866,60220.6
110,125,1618,815,803,57762.6
110,126,1423,730,693,49378.1
110,127,886,466,420,31187.2
111,4,7,5,2,254.1
111,5,1,0,1,0
111,12,1,0,1,0
111,13,1,0,1,0
111,64,1,0,1,0
111,70,2,1,1,0
111,71,8,3,5,368.8
111,72,3,1,2,0
111,83,3,2,1,0
111,84,10,5,5,361
111,103,9,6,3,357.3
111,104,41,25,16,1517
111,105,89,46,43,3168.4
111,106,6,3,3,292.2
111,115,30,17,13,1188
111,116,50,28,22,1755
111,117,81,40,41,2332.8
111,118,103,56,47,3357.8
111,119,105,62,43,3664.5
111,120,1284,654,630,49434
111,121,2566,1260,1306,101357
111,122,3800,1797,2003,144780
111,123,4435,2166,2269,168086.5
111,124,1974,982,992,70866.6
111,125,2690,1342,1348,99530
111,126,2855,1449,1406,103636.5
111,127,1206,623,583,42571.8
112,4,22,13,9,946
112,5,2,1,1,0
112,11,3,2,1,0
112,61,8,6,2,231.2
112,62,1,1,0,0
112,63,8,5,3,456
112,64,16,9,7,652.8
112,65,14,5,9,484.4
112,66,20,9,11,846
112,80,3,2,1,0
112,83,18,9,9,919.8
112,84,18,9,9,923.4
112,117,18,7,11,988.2
112,118,26,14,12,1245.4
112,119,250,128,122,8825
112,120,1248,648,600,47299.2
112,121,2359,1185,1174,88226.6
112,122,877,425,452,33150.6
112,123,1926,952,974,67987.8
112,124,1270,639,631,46228
112,125,2954,1448,1506,120227.8
112,126,3374,1650,1724,130236.4
112,127,3522,1697,1825,143697.6
113,4,2,2,0,0
113,11,5,2,3,171
113,61,2,1,1,0
113,62,2,1,1,0
113,65,5,2,3,202
113,66,6,3,3,277.2
113,67,8,4,4,462.4
113,68,13,6,7,601.9
113,71,20,10,10,840
113,72,7,5,2,238.7
113,73,5,1,4,167
113,74,1,1,0,0
113,82,29,16,13,1606.6
113,83,31,15,16,1457
113,84,3,2,1,0
113,105,15,7,8,562.5
113,117,10,6,4,557
113,118,1,0,1,0
113,119,4,2,2,0
113,120,791,409,382,24441.9
113,121,2634,1315,1319,91136.4
113,122,3286,1651,1635,127496.8
113,123,1294,644,650,51501.2
113,124,1971,1028,943,68985
113,125,1043,565,478,37235.1
113,126,2103,1069,1034,74235.9
113,127,1267,694,573,44978.5
114,4,8,4,4,403.2
114,62,6,1,5,205.2
114,66,2,1,1,0
114,67,42,22,20,1667.4
114,68,74,31,43,2856.4
114,69,20,12,8,842
114,70,15,6,9,687
114,71,6,3,3,220.2
114,72,18,8,10,671.4
114,73,3,2,1,0
114,74,18,9,9,676.8
114,75,9,4,5,412.2
114,76,8,4,4,416.8
114,78,7,3,4,387.1
114,80,20,10,10,730
114,81,11,5,6,501.6
114,82,34,21,13,1448.4
114,107,53,30,23,1637.7
114,108,39,19,20,1443
114,109,19,13,6,634.6
114,110,8,3,5,267.2
114,111,7,3,4,312.2
114,112,19,9,10,866.4
114,113,30,15,15,1053
114,114,10,4,6,206
114,115,11,6,5,440
114,116,63,38,25,2097.9
114,117,35,19,16,1428
114,119,56,29,27,1792
114,120,26,12,14,977.6
114,121,297,141,156,9801
114,122,745,380,365,27118
114,123,756,392,364,26762.4
114,124,1129,589,540,44821.3
114,125,1789,958,831,68518.7
114,126,1529,769,760,60548.4
114,127,2635,1377,1258,99076
115,3,2,1,1,0
115,4,6,2,4,207
115,11,7,4,3,280.7
115,65,3,1,2,0
115,66,7,2,5,342.3
115,68,11,6,5,397.1
115,73,6,2,4,88.8
115,75,10,5,5,360
115,76,5,3,2,153
115,77,12,5,7,717.6
115,78,2,1,1,0
115,80,38,21,17,1337.6
115,107,18,8,10,603
115,109,8,5,3,380.8
115,110,67,34,33,2298.1
115,111,24,15,9,885.6
115,112,39,22,17,1762.8
115,113,58,32,26,2157.6
115,114,36,20,16,1364.4
115,115,226,110,116,7503.2
115,116,992,495,497,30156.8
115,117,32,16,16,1168
115,118,33,19,14,1016.4
115,119,30,19,11,1353
115,120,43,22,21,1900.6
115,121,42,26,16,1768.2
115,122,41,21,20,1681
115,123,122,62,60,4501.8
115,124,842,425,417,31069.8
115,125,4192,2054,2138,159296
115,126,3675,1785,1890,141120
115,127,3402,1863,1539,108183.6
116,3,7,5,2,370.3
116,4,10,3,7,446
116,10,13,6,7,631.8
116,11,5,3,2,188
116,61,4,3,1,0
116,62,12,4,8,441.6
116,63,19,12,7,568.1
116,64,23,12,11,1064.9
116,65,15,7,8,529.5
116,77,4,1,3,0
116,78,10,5,5,430
116,80,8,6,2,291.2
116,109,2,1,1,0
116,110,25,9,16,945
116,112,28,15,13,943.6
116,113,11,6,5,424.6
116,114,626,335,291,20532.8
116,115,738,386,352,26715.6
116,116,27,13,14,1266.3
116,117,42,21,21,1625.4
116,118,42,24,18,1201.2
116,119,34,19,15,1071
116,120,100,57,43,3510
116,121,35,22,13,1288
116,122,39,21,18,1485.9
116,123,31,15,16,1305.1
116,124,17,7,10,630.7
116,125,1085,528,557,40687.5
116,126,2930,1445,1485,117493
116,127,3587,1902,1685,133077.7
117,2,10,6,4,445
117,3,9,6,3,332.1
117,10,9,5,4,192.6
117,11,2,1,1,0
117,61,24,14,10,1329.6
117,62,8,4,4,355.2
117,64,2,1,1,0
117,77,1,1,0,0
117,78,6,2,4,199.2
117,81,5,3,2,144
117,82,3,1,2,0
117,109,31,18,13,917.6
117,113,54,30,24,2219.4
117,114,714,342,372,28774.2
117,115,1129,558,571,39627.9
117,116,59,36,23,1905.7
117,117,61,29,32,2921.9
117,118,39,18,21,1556.1
117,119,46,24,22,1720.4
117,120,88,37,51,3432
117,121,23,14,9,834.9
117,125,108,53,55,3952.8
117,126,740,381,359,27306
117,127,3354,1629,1725,137849.4
118,0,19,10,9,872.1
118,1,15,7,8,675
118,2,2,1,1,0
118,10,8,4,4,480
118,11,9,5,4,399.6
118,61,8,5,3,324
118,78,16,10,6,740.8
118,79,3,3,0,0
118,80,10,6,4,579
118,109,15,8,7,807
118,110,157,83,74,5416.5
118,114,142,81,61,7313
118,115,33,17,16,1303.5
118,116,27,16,11,1212.3
118,117,16,9,7,449.6
118,118,74,29,45,2619.6
118,119,16,8,8,611.2
118,120,337,147,190,9840.4
118,121,48,24,24,1771.2
118,122,20,10,10,768
118,126,353,187,166,12425.6
118,127,2165,1087,1078,79239
119,9,5,3,2,249
119,10,14,10,4,376.6
119,11,18,10,8,577.8
119,77,25,14,11,1005
119,78,51,22,29,2040
119,79,19,8,11,896.8
119,80,5,3,2,148
119,81,2,1,1,0
119,110,26,14,12,943.8
119,111,27,15,12,1004.4
119,117,64,29,35,2579.2
119,118,10,4,6,382
119,119,17,7,10,491.3
119,120,43,21,22,1909.2
119,121,24,15,9,1152
119,122,77,32,45,3026.1
119,123,11,5,6,568.7
119,124,64,40,24,2150.4
119,125,56,30,26,1881.6
119,126,458,244,214,15572
119,127,611,310,301,20835.1
120,55,1,1,0,0
120,58,2,1,1,0
120,75,7,5,2,221.9
120,76,6,3,3,280.8
120,77,13,6,7,601.9
120,81,2,1,1,0
120,83,1,1,0,0
120,111,22,13,9,1020.8
120,119,9,4,5,294.3
120,121,2,1,1,0
120,122,15,7,8,838.5
120,123,39,23,16,1345.5
120,124,2,1,1,0
120,125,136,73,63,5943.2
120,126,78,38,40,2971.8
120,127,769,381,388,24223.5
121,0,34,17,17,1516.4
121,1,6,3,3,214.8
121,6,8,5,3,327.2
121,7,3,0,3,0
121,54,1,0,1,0
121,55,1,0,1,0
121,75,30,12,18,936
121,76,4,2,2,0
121,111,1,1,0,0
121,119,9,6,3,465.3
121,121,8,8,0,344
121,122,17,10,7,438.6
121,123,10,7,3,268
121,124,30,14,16,1338
121,125,43,29,14,1814.6
121,126,133,60,73,3790.5
121,127,1436,693,743,46239.2
122,0,27,15,12,947.7
122,1,113,65,48,3672.5
122,2,29,15,14,1255.7
122,3,33,17,16,1263.9
122,4,23,13,10,782
122,5,19,8,11,549.1
122,71,1,0,1,0
122,74,4,2,2,0
122,75,42,21,21,1990.8
122,76,14,6,8,386.4
122,118,3,2,1,0
122,119,27,13,14,1093.5
122,124,25,14,11,940
122,125,20,9,11,654
122,126,23,12,11,1046.5
122,127,432,225,207,15249.6
123,0,49,24,25,1749.3
123,1,48,28,20,2097.6
123,2,69,28,41,2697.9
123,3,25,13,12,1132.5
123,4,1,1,0,0
123,72,11,6,5,431.2
123,73,22,11,11,880
123,74,78,40,38,3237
123,119,2,1,1,0
123,124,30,14,16,1125
123,125,12,8,4,566.4
123,126,26,17,9,878.8
124,0,114,47,67,6384
124,1,107,47,60,4718.7
124,2,8,5,3,290.4
124,6,6,3,3,250.8
124,72,7,3,4,333.2
124,73,32,16,16,1392
124,74,52,25,27,1939.6
124,122,1,1,0,0
124,123,9,3,6,196.2
124,125,1,1,0,0
124,126,6,3,3,180
125,0,321,154,167,13674.6
125,1,66,31,35,2725.8
125,8,3,2,1,0
125,65,1,1,0,0
125,68,13,7,6,507
125,69,18,9,9,849.6
125,70,30,14,16,1083
125,71,7,4,3,345.8
125,75,2,2,0,0
125,76,13,8,5,374.4
125,118,4,2,2,0
125,119,2,2,0,0
125,120,4,2,2,0
125,123,9,4,5,468
125,125,12,6,6,483.6
125,127,42,23,19,1680
126,0,116,65,51,4454.4
126,1,28,15,13,1114.4
126,2,28,14,14,1411.2
126,72,6,5,1,181.8
126,75,21,12,9,930.3
126,76,41,20,21,1877.8
126,111,4,1,3,0
126,112,29,18,11,904.8
126,118,2,1,1,0
126,119,8,4,4,444.8
126,124,38,23,15,1193.2
126,125,15,8,7,559.5
126,126,38,20,18,1314.8
126,127,34,19,15,1322.6
127,0,5,3,2,206
127,1,37,21,16,1483.7
127,2,13,7,6,751.4
127,75,122,64,58,5380.2
127,76,43,15,28,2429.5
127,77,5,3,2,281
127,111,6,3,3,334.2
127,112,63,32,31,1789.2
127,113,10,6,4,219
127,122,7,3,4,391.3
127,124,10,4,6,537
127,125,22,11,11,937.2
127,127,93,46,47,3301.5