x,y,p,m,f,ta
14,18,1,0,1,0
14,32,5,2,3,99
15,32,6,2,4,265.8
16,36,24,12,12,816
16,37,10,7,3,203
17,31,3,2,1,0
17,33,2,2,0,0
17,35,16,8,8,702.4
18,35,9,6,3,356.4
19,2,5,2,3,290
19,32,16,9,7,689.6
19,36,8,5,3,458.4
19,37,2,1,1,0
20,0,3,2,1,0
20,29,1,1,0,0
20,30,10,6,4,288
20,31,3,1,2,0
20,33,4,2,2,0
20,37,2,1,1,0
20,38,8,4,4,451.2
21,0,3,1,2,0
21,38,32,15,17,960
22,1,28,14,14,1388.8
22,31,1,0,1,0
22,32,7,3,4,338.1
22,33,1,1,0,0
22,35,7,4,3,261.8
22,42,1,0,1,0
22,43,2,2,0,0
23,37,20,7,13,1122
23,39,3,2,1,0
23,43,15,6,9,433.5
23,44,7,3,4,294
24,0,5,1,4,193
24,32,19,14,5,748.6
24,33,16,6,10,585.6
24,35,13,8,5,564.2
24,36,2,1,1,0
24,37,27,18,9,980.1
24,39,2,1,1,0
24,40,3,2,1,0
24,45,5,3,2,179
25,36,14,6,8,565.6
25,37,3,1,2,0
25,39,7,3,4,322
25,40,4,2,2,0
26,31,3,2,1,0
26,36,6,5,1,258
26,41,9,5,4,387.9
27,5,12,5,7,332.4
27,37,2,2,0,0
28,5,20,9,11,1054
28,32,2,1,1,0
28,41,7,5,2,203.7
29,5,10,6,4,591
29,34,3,2,1,0
29,35,1,1,0,0
29,40,6,3,3,286.2
30,5,4,2,2,0
30,31,6,3,3,367.2
30,32,10,5,5,381
30,34,3,2,1,0
30,37,6,4,2,270
30,38,18,8,10,912.6
30,40,13,5,8,500.5
30,41,6,4,2,346.8
31,3,9,5,4,488.7
31,4,11,6,5,425.7
31,29,5,2,3,123
31,30,23,12,11,844.1
31,31,6,4,2,306
31,32,20,10,10,620
31,33,5,3,2,289
31,34,5,3,2,70
31,35,4,3,1,0
31,37,2,2,0,0
31,39,3,2,1,0
31,42,3,2,1,0
31,43,16,6,10,750.4
32,29,9,6,3,267.3
32,30,9,6,3,317.7
32,31,18,8,10,567
32,35,1,1,0,0
32,36,6,4,2,448.2
32,37,4,2,2,0
32,43,2,1,1,0
33,5,17,10,7,596.7
33,15,54,24,30,2149.2
33,29,5,2,3,247
33,30,1,0,1,0
33,35,8,4,4,260
34,0,2,1,1,0
34,6,16,10,6,539.2
34,7,2,1,1,0
34,8,1,0,1,0
34,9,13,7,6,377
34,15,75,35,40,2940
34,16,18,11,7,570.6
34,28,16,7,9,740.8
34,29,23,10,13,922.3
34,34,2,1,1,0
34,35,2,1,1,0
34,37,29,18,11,1067.2
34,38,6,2,4,198
34,39,2,1,1,0
34,40,7,5,2,419.3
34,43,1,1,0,0
35,0,21,11,10,999.6
35,4,6,2,4,213
35,5,5,2,3,265
35,7,14,6,8,757.4
35,8,11,7,4,245.3
35,15,2,1,1,0
35,16,2,1,1,0
35,28,18,11,7,583.2
35,29,14,8,6,432.6
35,30,13,5,8,367.9
35,36,10,7,3,466
35,37,15,7,8,636
35,38,1,1,0,0
36,0,7,3,4,408.8
36,1,8,6,2,220.8
36,5,17,8,9,688.5
36,7,3,2,1,0
36,17,13,7,6,652.6
36,26,1,1,0,0
36,27,11,6,5,533.5
36,28,6,2,4,270
36,29,213,96,117,6326.1
36,30,423,223,200,12816.9
36,36,10,3,7,398
37,0,14,9,5,420
37,3,2,1,1,0
37,4,14,6,8,618.8
37,5,9,5,4,496.8
37,6,35,18,17,1060.5
37,7,92,39,53,4636.8
37,25,2,1,1,0
37,28,8,6,2,284.8
37,29,171,86,85,6190.2
37,30,1329,663,666,56216.7
37,31,508,258,250,17983.2
37,32,10,5,5,559
37,36,8,5,3,359.2
37,37,9,6,3,287.1
37,38,3,2,1,0
38,3,6,3,3,207
38,4,31,14,17,892.8
38,5,9,5,4,288
38,7,10,5,5,522
38,10,1,1,0,0
38,17,17,11,6,613.7
38,18,1,0,1,0
38,25,7,4,3,321.3
38,26,10,8,2,395
38,28,16,8,8,558.4
38,29,10,7,3,224
38,30,335,151,184,14505.5
38,31,144,71,73,5832
38,32,9,4,5,285.3
38,33,24,10,14,796.8
38,34,46,23,23,1669.8
38,35,32,15,17,1232
38,36,24,9,15,1020
39,1,15,8,7,763.5
39,2,4,2,2,0
39,5,6,4,2,226.8
39,9,9,4,5,447.3
39,10,23,10,13,1090.2
39,17,17,12,5,758.2
39,18,13,6,7,600.6
39,21,5,3,2,126
39,22,7,3,4,359.8
39,23,23,9,14,874
39,24,2,2,0,0
39,26,4,1,3,0
39,27,8,4,4,308
39,28,15,8,7,622.5
39,29,76,40,36,2660
39,30,1,1,0,0
39,31,43,19,24,1548
39,32,132,68,64,4606.8
39,33,12,6,6,513.6
39,34,13,6,7,360.1
40,2,18,10,8,838.8
40,3,18,9,9,948.6
40,4,16,9,7,814.4
40,5,4,2,2,0
40,9,1,1,0,0
40,10,13,7,6,717.6
40,18,8,5,3,280.8
40,22,22,13,9,814
40,25,7,5,2,329
40,27,7,3,4,336
40,28,15,8,7,553.5
40,29,87,47,40,3488.7
40,30,71,38,33,2903.9
40,31,12,7,5,543.6
40,32,3,1,2,0
40,34,12,7,5,385.2
40,35,23,11,12,710.7
40,36,7,4,3,380.8
41,0,2,1,1,0
41,3,2,1,1,0
41,4,18,8,10,487.8
41,5,16,7,9,841.6
41,6,15,7,8,616.5
41,7,7,4,3,392
41,17,5,3,2,179
41,22,2,1,1,0
41,24,6,3,3,369
41,25,71,38,33,2030.6
41,26,19,10,9,499.7
41,27,5,2,3,331
41,28,3,2,1,0
41,29,7,3,4,536.9
41,30,5,2,3,132
41,35,12,5,7,475.2
41,36,85,46,39,2915.5
42,0,13,8,5,616.2
42,2,3,1,2,0
42,3,13,7,6,639.6
42,17,4,3,1,0
42,23,9,6,3,296.1
42,24,46,19,27,1692.8
42,25,9,5,4,324.9
42,26,10,6,4,244
42,27,10,6,4,432
42,28,8,4,4,487.2
42,29,1,1,0,0
42,30,2,1,1,0
42,32,3,2,1,0
42,33,13,8,5,666.9
42,37,33,17,16,943.8
43,0,3,1,2,0
43,1,9,7,2,519.3
43,19,11,7,4,402.6
43,20,9,4,5,415.8
43,23,6,2,4,382.2
43,24,21,13,8,963.9
43,26,9,7,2,284.4
43,27,6,4,2,231
43,28,23,14,9,970.6
43,29,25,16,9,712.5
43,30,13,7,6,418.6
43,33,15,8,7,717
43,34,8,4,4,218.4
43,37,4,1,3,0
44,18,3,2,1,0
44,20,12,6,6,360
44,21,2,2,0,0
44,23,33,16,17,1026.3
44,24,4,3,1,0
44,25,6,5,1,172.2
44,26,15,8,7,586.5
44,27,9,5,4,198
44,28,9,4,5,588.6
45,0,5,2,3,302
45,1,5,3,2,286
45,2,2,2,0,0
45,10,4,1,3,0
45,11,2,1,1,0
45,12,4,2,2,0
45,19,2,1,1,0
45,20,7,4,3,198.1
45,21,44,25,19,1179.2
45,22,23,10,13,1117.8
45,23,17,6,11,569.5
45,25,13,8,5,557.7
45,26,3,2,1,0
45,27,1,1,0,0
45,28,13,7,6,292.5
45,30,4,1,3,0
45,35,3,2,1,0
46,10,35,21,14,1414
46,11,23,12,11,1035
46,12,31,14,17,1199.7
46,22,27,17,10,1393.2
46,23,10,5,5,209
46,24,10,4,6,323
46,28,4,3,1,0
46,29,11,8,3,387.2
46,30,4,2,2,0
46,31,7,2,5,315.7
46,32,3,2,1,0
47,11,3,1,2,0
47,21,4,1,3,0
47,22,1,0,1,0
47,23,36,18,18,1738.8
47,24,25,11,14,1115
47,25,5,1,4,139
47,28,7,4,3,181.3
47,29,3,3,0,0
47,31,2,1,1,0
47,36,11,8,3,189.2
47,37,12,8,4,513.6
47,38,4,1,3,0
47,39,4,3,1,0
48,23,35,17,18,1214.5
48,24,12,7,5,352.8
48,37,46,24,22,2148.2
48,39,14,7,7,620.2
49,23,9,4,5,324.9
49,24,7,4,3,315.7
49,25,6,3,3,250.8
49,27,1,1,0,0
49,28,14,6,8,569.8
49,36,2,1,1,0
49,37,18,6,12,534.6
49,38,44,24,20,2125.2
50,14,2,1,1,0
50,15,12,7,5,639.6
50,22,2,1,1,0
50,23,13,5,8,491.4
50,24,21,11,10,1058.4
50,25,20,10,10,946
50,27,14,8,6,498.4
50,28,21,12,9,879.9
50,35,3,2,1,0
50,36,3,1,2,0
50,37,24,12,12,940.8
50,38,5,2,3,279
50,39,2,2,0,0
51,17,5,3,2,359
51,23,6,4,2,279
51,24,15,7,8,676.5
51,25,3,2,1,0
51,27,3,1,2,0
51,28,21,9,12,833.7
51,29,21,12,9,613.2
51,32,5,2,3,148
51,34,6,4,2,216
51,35,5,3,2,333
51,36,13,6,7,444.6
52,16,4,1,3,0
52,24,22,12,10,919.6
52,25,5,3,2,196
52,28,12,6,6,649.2
52,29,25,10,15,925
52,34,2,1,1,0
52,36,7,4,3,254.1
53,18,10,5,5,367
53,25,43,23,20,1556.6
53,28,11,6,5,484
53,29,9,5,4,326.7
53,30,7,3,4,263.9
53,32,6,3,3,199.2
53,36,8,3,5,351.2
53,50,2,1,1,0
53,51,2,1,1,0
53,53,2,1,1,0
54,18,31,15,16,1426
54,25,16,9,7,764.8
54,28,118,56,62,3858.6
54,29,521,274,247,20735.8
54,30,109,50,59,3357.2
54,32,2,1,1,0
54,34,4,4,0,0
54,35,1,1,0,0
54,50,5,4,1,236
54,51,26,13,13,1502.8
54,53,5,2,3,216
55,16,1,1,0,0
55,18,11,7,4,404.8
55,23,6,4,2,255
55,24,5,2,3,218
55,25,29,13,16,1107.8
55,28,46,25,21,1706.6
55,29,784,354,430,35907.2
55,30,85,46,39,3213
55,35,13,5,8,305.5
55,36,2,1,1,0
55,50,2,1,1,0
55,53,10,5,5,332
55,54,4,1,3,0
55,55,11,6,5,445.5
56,19,3,2,1,0
56,24,10,8,2,434
56,28,4,2,2,0
56,29,11,7,4,496.1
56,31,8,5,3,328
56,37,27,15,12,901.8
56,42,7,3,4,343.7
56,43,13,8,5,512.2
56,49,6,4,2,295.8
56,50,32,16,16,1798.4
56,51,8,5,3,444
56,55,1,1,0,0
57,28,2,2,0,0
57,29,1,1,0,0
57,30,7,3,4,275.1
57,31,4,3,1,0
57,36,7,3,4,245.7
57,37,3,2,1,0
57,51,14,7,7,389.2
57,56,1,0,1,0
58,29,3,2,1,0
58,31,3,1,2,0
58,33,2,1,1,0
58,34,3,2,1,0
58,37,2,2,0,0
58,39,9,4,5,559.8
58,40,3,2,1,0
58,44,11,5,6,313.5
58,45,2,0,2,0
58,49,1,1,0,0
58,50,2,1,1,0
58,56,1,0,1,0
59,23,10,5,5,410
59,29,1,1,0,0
59,44,12,7,5,423.6
59,50,1,0,1,0
59,51,4,2,2,0
59,52,37,19,18,1235.8
59,53,6,3,3,202.2
59,56,2,1,1,0
60,31,3,2,1,0
60,33,2,1,1,0
60,34,3,2,1,0
60,35,6,5,1,165
60,39,2,1,1,0
60,42,9,6,3,423
60,44,2,2,0,0
60,51,14,7,7,761.6
60,52,1,0,1,0
60,53,39,19,20,1805.7
60,54,1,0,1,0
60,55,18,9,9,721.8
60,56,9,2,7,344.7
61,23,2,1,1,0
61,35,4,2,2,0
61,36,4,1,3,0
61,39,1,0,1,0
61,40,4,2,2,0
61,42,2,1,1,0
61,43,14,9,5,422.8
61,44,38,22,16,1717.6
61,45,14,6,8,786.8
61,53,10,4,6,567
61,54,81,32,49,3790.8
61,55,77,42,35,3249.4
61,56,20,10,10,612
62,36,10,4,6,475
62,44,6,2,4,171
62,54,21,11,10,989.1
62,55,25,12,13,1170
63,22,6,2,4,213
63,37,9,4,5,234.9
63,38,8,4,4,284.8
63,39,2,1,1,0
63,42,14,8,6,708.4
63,43,10,6,4,608
63,45,1,1,0,0
63,48,1,1,0,0
63,54,6,2,4,196.8
63,55,1,1,0,0
64,34,9,6,3,351
64,39,9,4,5,338.4
64,40,7,4,3,289.8
64,46,2,1,1,0
65,21,31,14,17,1760.8
65,22,38,19,19,2329.4
65,34,8,4,4,208.8
65,40,3,2,1,0
65,44,5,4,1,178
65,45,1,1,0,0
65,52,2,1,1,0
66,21,41,21,20,2074.6
66,22,11,6,5,622.6
66,34,3,2,1,0
66,40,5,2,3,218
66,41,10,6,4,361
66,42,9,4,5,286.2
66,46,2,1,1,0
66,53,12,5,7,775.2
67,21,49,30,19,1484.7
67,22,10,6,4,706
67,23,3,2,1,0
67,35,8,4,4,347.2
67,46,5,3,2,241
67,47,2,1,1,0
67,48,7,3,4,259.7
67,53,17,6,11,1054
67,54,9,4,5,509.4
68,15,1,1,0,0
68,22,2,1,1,0
68,23,4,2,2,0
68,35,20,13,7,934
68,36,1,0,1,0
68,47,10,6,4,386
68,49,1,0,1,0
68,54,13,7,6,728
68,55,2,1,1,0
68,56,2,1,1,0
69,35,16,9,7,604.8
69,36,6,4,2,370.2
69,48,8,6,2,298.4
69,49,5,2,3,211
69,57,6,2,4,261
69,119,5,3,2,300
70,36,2,1,1,0
70,37,11,6,5,555.5
70,57,3,2,1,0
70,112,39,22,17,1579.5
70,121,8,3,5,258.4
71,38,11,4,7,445.5
71,51,2,1,1,0
71,111,3,1,2,0
71,112,1,0,1,0
71,119,8,5,3,340
71,120,20,8,12,754
71,121,2,1,1,0
71,122,18,12,6,1040.4
72,37,13,5,8,665.6
72,38,18,10,8,928.8
72,51,9,4,5,359.1
72,52,21,10,11,942.9
72,55,5,4,1,162
72,112,18,10,8,615.6
72,117,1,1,0,0
72,120,26,13,13,1235
72,121,24,14,10,1111.2
72,122,5,2,3,204
73,37,4,2,2,0
73,51,5,3,2,293
73,52,7,4,3,349.3
73,53,9,5,4,306
73,55,9,4,5,452.7
73,110,1,1,0,0
73,112,21,10,11,751.8
73,113,21,11,10,919.8
73,116,11,4,7,479.6
73,117,22,15,7,787.6
73,118,13,4,9,366.6
74,38,16,11,5,622.4
74,52,7,5,2,387.1
74,53,12,4,8,463.2
74,55,23,10,13,901.6
74,56,26,15,11,1227.2
74,67,1,1,0,0
74,116,2,2,0,0
74,117,16,7,9,580.8
74,118,16,11,5,553.6
74,120,19,10,9,568.1
74,121,25,10,15,890
74,122,103,55,48,4243.6
74,123,8,4,4,328.8
75,39,13,5,8,886.6
75,53,10,6,4,466
75,54,4,2,2,0
75,55,15,5,10,703.5
75,56,4,2,2,0
75,57,4,1,3,0
75,58,3,2,1,0
75,114,2,1,1,0
75,115,33,18,15,1405.8
75,116,1,1,0,0
75,117,3,2,1,0
75,119,54,27,27,2327.4
75,120,13,7,6,712.4
75,121,6,4,2,400.8
75,122,89,46,43,3835.9
76,40,5,3,2,179
76,53,21,11,10,770.7
76,58,4,2,2,0
76,59,17,11,6,399.5
76,60,3,1,2,0
76,61,6,4,2,355.2
76,68,6,3,3,199.2
76,69,9,5,4,541.8
76,70,4,3,1,0
76,113,18,9,9,669.6
76,116,4,2,2,0
76,117,1,1,0,0
76,118,5,4,1,145
76,119,251,121,130,10818.1
76,120,18,9,9,817.2
77,39,1,1,0,0
77,40,16,8,8,772.8
77,67,20,10,10,794
77,68,9,2,7,502.2
77,114,12,5,7,544.8
77,116,8,4,4,392
77,117,11,6,5,479.6
77,118,5,3,2,239
77,119,5,1,4,243
77,121,6,3,3,388.2
78,39,13,6,7,426.4
78,40,14,6,8,537.6
78,52,18,12,6,703.8
78,55,3,1,2,0
78,67,4,3,1,0
78,116,18,9,9,865.8
78,119,4,3,1,0
78,120,7,4,3,361.2
78,121,17,11,6,931.6
78,122,1,1,0,0
79,47,1,1,0,0
79,48,2,1,1,0
79,50,2,1,1,0
79,56,7,4,3,410.9
79,69,2,1,1,0
79,118,8,3,5,232
79,120,9,4,5,541.8
79,121,4,2,2,0
79,122,11,4,7,377.3
80,58,1,1,0,0
80,63,2,1,1,0
80,64,3,2,1,0
80,69,5,2,3,307
80,70,27,17,10,899.1
80,71,5,4,1,276
80,89,20,12,8,788
80,90,26,17,9,1157
80,91,16,8,8,788.8
80,118,4,3,1,0
81,48,3,2,1,0
81,49,4,1,3,0
81,57,5,2,3,195
81,59,1,1,0,0
81,61,4,2,2,0
81,63,26,14,12,819
81,64,17,11,6,598.4
81,69,4,2,2,0
81,70,19,13,6,693.5
81,71,7,5,2,322
81,73,9,4,5,126
81,75,7,5,2,328.3
81,77,7,4,3,298.2
81,87,9,4,5,233.1
81,88,2,2,0,0
81,89,37,18,19,1687.2
81,90,33,16,17,1419
81,91,5,3,2,186
81,97,1,1,0,0
81,127,1,1,0,0
82,37,1,1,0,0
82,38,15,9,6,664.5
82,39,117,64,53,4761.9
82,48,9,4,5,639
82,57,2,1,1,0
82,64,18,9,9,828
82,65,2,1,1,0
82,72,8,3,5,299.2
82,73,32,15,17,1120
82,74,36,18,18,1458
82,75,39,15,24,1415.7
82,76,1,1,0,0
82,77,14,8,6,742
82,78,20,7,13,722
82,79,4,2,2,0
82,80,5,4,1,319
82,89,6,2,4,250.2
82,90,13,7,6,600.6
82,91,32,14,18,857.6
82,92,2,1,1,0
82,98,4,3,1,0
82,118,12,5,7,512.4
83,35,4,2,2,0
83,37,1,1,0,0
83,38,14,10,4,466.2
83,39,11,8,3,617.1
83,41,2,1,1,0
83,43,1,1,0,0
83,45,2,1,1,0
83,57,6,2,4,295.8
83,58,5,3,2,145
83,63,2,0,2,0
83,64,14,8,6,718.2
83,69,5,1,4,169
83,70,9,4,5,380.7
83,71,3,1,2,0
83,73,8,4,4,304
83,74,26,12,14,1050.4
83,75,16,9,7,627.2
83,76,44,21,23,1896.4
83,77,131,69,62,4991.1
83,78,83,41,42,2913.3
83,90,12,5,7,422.4
83,93,23,13,10,733.7
83,94,26,14,12,1081.6
83,95,226,127,99,8090.8
83,118,1,0,1,0
83,119,28,12,16,1422.4
83,120,12,4,8,536.4
84,0,22,13,9,613.8
84,37,5,4,1,155
84,38,7,3,4,237.3
84,50,3,2,1,0
84,56,4,1,3,0
84,57,16,8,8,782.4
84,75,1,1,0,0
84,76,7,3,4,497.7
84,77,117,47,70,6212.7
84,78,119,60,59,4950.4
84,79,11,6,5,478.5
84,80,5,1,4,138
84,82,1,1,0,0
84,83,12,5,7,423.6
84,84,22,11,11,1003.2
84,85,6,3,3,178.2
84,86,84,43,41,2948.4
84,94,12,6,6,663.6
84,95,257,121,136,7967
84,96,27,12,15,969.3
84,110,1,1,0,0
84,119,21,10,11,987
85,0,44,24,20,1892
85,1,17,10,7,748
85,36,8,4,4,308
85,37,12,6,6,556.8
85,38,11,6,5,425.7
85,49,2,1,1,0
85,57,73,31,42,3766.8
85,58,35,17,18,1757
85,66,1,1,0,0
85,77,4,3,1,0
85,78,17,9,8,639.2
85,80,5,3,2,244
85,81,46,24,22,1573.2
85,82,12,8,4,488.4
85,83,42,20,22,1940.4
85,84,386,186,200,15247
85,85,40,23,17,1612
85,86,14,6,8,484.4
85,93,154,83,71,5651.8
85,94,53,26,27,2183.6
85,95,238,125,113,8330
85,96,102,51,51,3223.2
85,113,1,0,1,0
85,114,21,12,9,1167.6
86,0,60,27,33,2082
86,1,304,147,157,12676.8
86,2,77,38,39,3095.4
86,3,8,4,4,316
86,37,1,1,0,0
86,49,2,1,1,0
86,55,3,2,1,0
86,56,38,18,20,1455.4
86,57,129,73,56,5430.9
86,58,4,2,2,0
86,61,1,1,0,0
86,65,13,8,5,682.5
86,76,5,4,1,190
86,77,6,4,2,183
86,79,24,11,13,914.4
86,80,21,11,10,659.4
86,81,47,24,23,1654.4
86,82,7,4,3,380.8
86,83,54,24,30,2548.8
86,84,68,36,32,2781.2
86,85,23,15,8,1186.8
86,88,1,1,0,0
86,89,23,14,9,876.3
86,94,406,195,211,18351.2
86,95,967,446,521,41484.3
86,96,153,70,83,5691.6
86,114,3,2,1,0
87,1,34,18,16,1485.8
87,2,33,17,16,1739.1
87,3,47,23,24,1847.1
87,4,6,2,4,229.2
87,13,14,7,7,511
87,35,9,4,5,466.2
87,37,4,2,2,0
87,57,22,9,13,884.4
87,58,1,1,0,0
87,63,8,5,3,386.4
87,64,2,1,1,0
87,65,10,4,6,485
87,73,3,1,2,0
87,74,4,2,2,0
87,76,6,3,3,126
87,79,4,4,0,0
87,80,6,3,3,373.8
87,81,17,8,9,544
87,82,25,15,10,935
87,83,8,4,4,398.4
87,84,7,3,4,385.7
87,86,24,11,13,1070.4
87,90,3,1,2,0
87,95,206,97,109,8528.4
87,96,983,461,522,42269
87,97,626,292,334,24226.2
87,98,3,1,2,0
88,0,2,1,1,0
88,1,16,7,9,545.6
88,2,18,11,7,968.4
88,3,4,2,2,0
88,4,4,3,1,0
88,5,2,1,1,0
88,6,16,8,8,627.2
88,8,11,6,5,324.5
88,9,5,3,2,99
88,10,5,4,1,142
88,11,4,2,2,0
88,12,4,3,1,0
88,13,4,2,2,0
88,15,8,5,3,368.8
88,16,6,1,5,249
88,37,5,4,1,159
88,50,2,2,0,0
88,61,4,2,2,0
88,63,10,7,3,470
88,74,16,9,7,732.8
88,75,2,0,2,0
88,81,6,4,2,256.2
88,82,32,15,17,1296
88,83,4,1,3,0
88,85,17,11,6,649.4
88,86,1,1,0,0
88,87,3,1,2,0
88,91,9,3,6,308.7
88,95,3,1,2,0
88,96,6,3,3,186
88,97,590,284,306,18172
88,98,566,271,295,20036.4
88,99,32,15,17,1036.8
88,100,2,1,1,0
89,3,11,7,4,513.7
89,8,25,15,10,1092.5
89,12,1,0,1,0
89,13,3,1,2,0
89,14,16,8,8,473.6
89,15,3,1,2,0
89,16,9,3,6,243.9
89,19,8,3,5,263.2
89,36,9,5,4,496.8
89,68,1,1,0,0
89,70,2,1,1,0
89,71,5,3,2,249
89,79,8,4,4,306.4
89,83,13,7,6,618.8
89,85,12,8,4,421.2
89,86,30,18,12,924
89,87,23,13,10,821.1
89,89,13,10,3,369.2
89,91,5,2,3,287
89,97,22,14,8,981.2
89,98,102,51,51,3580.2
89,99,27,13,14,839.7
89,101,22,14,8,855.8
89,102,10,4,6,391
89,103,23,13,10,986.7
89,104,8,4,4,490.4
90,12,12,6,6,514.8
90,14,6,4,2,292.2
90,15,2,1,1,0
90,21,9,5,4,351.9
90,54,1,1,0,0
90,71,5,3,2,228
90,79,3,2,1,0
90,84,1,1,0,0
90,85,5,3,2,322
90,86,6,3,3,319.2
90,87,16,10,6,529.6
90,88,5,2,3,132
90,91,7,4,3,224.7
90,92,26,14,12,1092
90,95,2,1,1,0
90,96,5,4,1,89
90,97,7,5,2,196
90,101,15,10,5,769.5
90,104,8,5,3,440.8
90,108,3,1,2,0
91,21,2,1,1,0
91,22,8,3,5,303.2
91,51,16,9,7,550.4
91,52,202,102,100,7999.2
91,63,1,1,0,0
91,79,1,0,1,0
91,85,6,4,2,316.2
91,86,11,6,5,342.1
91,88,3,2,1,0
91,92,7,4,3,282.1
91,93,6,2,4,210
91,95,9,6,3,399.6
91,96,29,17,12,1133.9
91,97,33,22,11,1013.1
91,98,27,10,17,899.1
91,99,3,1,2,0
91,100,9,5,4,203.4
91,105,7,4,3,448.7
91,106,19,10,9,674.5
91,107,18,11,7,878.4
92,33,3,2,1,0
92,52,266,125,141,13805.4
92,53,13,6,7,669.5
92,56,5,3,2,145
92,57,1,1,0,0
92,68,7,4,3,275.8
92,79,2,2,0,0
92,80,4,3,1,0
92,85,8,5,3,294.4
92,86,7,3,4,158.9
92,92,14,8,6,533.4
92,93,15,9,6,480
92,94,4,2,2,0
92,95,24,15,9,633.6
92,96,71,36,35,2698
92,97,23,13,10,938.4
92,98,27,13,14,1026
92,99,22,10,12,618.2
92,100,9,4,5,358.2
92,105,5,3,2,272
92,107,3,2,1,0
92,117,4,3,1,0
93,26,15,8,7,691.5
93,27,7,4,3,378.7
93,31,1,0,1,0
93,52,10,5,5,712
93,53,46,24,22,1876.8
93,57,2,1,1,0
93,71,1,1,0,0
93,79,8,4,4,412.8
93,81,2,1,1,0
93,94,25,14,11,1095
93,95,63,36,27,2079
93,96,10,5,5,507
93,97,54,25,29,1825.2
93,98,37,22,15,1457.8
93,99,2,1,1,0
93,100,2,1,1,0
94,26,9,2,7,304.2
94,27,16,7,9,542.4
94,28,38,20,18,1706.2
94,29,19,13,6,765.7
94,53,15,6,9,604.5
94,95,10,5,5,229
94,96,11,7,4,451
94,99,1,1,0,0
94,100,2,1,1,0
94,110,5,3,2,297
94,113,14,9,5,418.6
94,114,3,3,0,0
94,119,7,6,1,303.1
95,29,6,2,4,283.2
95,30,5,2,3,177
95,73,3,2,1,0
95,98,3,1,2,0
95,113,2,1,1,0
95,114,15,9,6,613.5
95,115,8,6,2,428.8
95,119,1,0,1,0
95,120,1,1,0,0
96,0,9,8,1,372.6
96,30,2,1,1,0
96,49,1,0,1,0
96,50,6,2,4,124.8
96,51,4,2,2,0
96,73,6,4,2,238.8
96,90,2,1,1,0
96,91,17,9,8,1004.7
96,97,7,3,4,244.3
96,98,1,0,1,0
96,99,2,1,1,0
96,116,3,2,1,0
96,117,11,5,6,320.1
96,118,1,0,1,0
96,119,8,4,4,444
96,120,1,0,1,0
97,49,9,5,4,516.6
97,84,2,1,1,0
97,86,2,2,0,0
97,89,2,1,1,0
97,90,11,6,5,555.5
97,91,13,6,7,799.5
97,96,6,5,1,319.2
97,97,8,4,4,359.2
97,118,12,6,6,658.8
97,119,52,26,26,1991.6
97,120,27,13,14,915.3
97,121,8,6,2,403.2
97,127,5,4,1,276
98,48,6,3,3,196.2
98,49,3,2,1,0
98,55,38,19,19,1660.6
98,80,2,1,1,0
98,88,4,2,2,0
98,119,7,2,5,275.1
98,120,102,45,57,5018.4
98,121,33,14,19,1171.5
98,123,9,6,3,275.4
99,48,14,8,6,533.4
99,49,5,3,2,224
99,55,17,9,8,513.4
99,56,13,7,6,569.4
99,80,14,7,7,315
99,86,2,1,1,0
99,87,5,3,2,150
99,90,4,2,2,0
99,93,2,1,1,0
99,121,12,6,6,586.8
99,122,22,12,10,954.8
100,0,17,9,8,734.4
100,46,20,8,12,808
100,47,22,10,12,963.6
100,49,15,9,6,421.5
100,56,4,2,2,0
100,81,2,1,1,0
100,82,8,4,4,348
100,87,2,2,0,0
100,90,4,2,2,0
100,122,12,7,5,530.4
100,123,9,6,3,321.3
101,0,4,1,3,0
101,1,1,1,0,0
101,2,2,1,1,0
101,86,1,0,1,0
101,87,4,3,1,0
101,88,44,17,27,1588.4
101,92,2,1,1,0
101,123,5,3,2,246
101,124,11,4,7,322.3
102,86,6,3,3,306
102,87,146,64,82,6643
102,88,130,64,66,5122
102,89,7,4,3,237.3
102,91,3,2,1,0
102,92,3,2,1,0
102,124,2,1,1,0
103,4,4,2,2,0
103,77,2,2,0,0
103,87,3,2,1,0
103,90,3,2,1,0
103,91,24,13,11,984
103,99,1,1,0,0
103,126,1,1,0,0
104,5,7,3,4,203
104,71,1,1,0,0
104,86,31,16,15,1147
104,91,32,15,17,1388.8
104,101,1,1,0,0
104,126,2,1,1,0
104,127,19,7,12,868.3
105,5,1,1,0,0
105,74,2,1,1,0
105,77,3,1,2,0
105,85,3,2,1,0
105,86,5,2,3,225
105,88,3,2,1,0
105,89,5,3,2,231
105,120,6,3,3,370.2
105,123,28,16,12,1282.4
105,126,2,1,1,0
105,127,1,0,1,0
106,16,6,3,3,226.2
106,17,4,3,1,0
106,71,2,1,1,0
106,73,3,2,1,0
106,75,11,5,6,453.2
106,76,2,1,1,0
106,77,16,11,5,483.2
106,78,27,14,13,1174.5
106,82,2,1,1,0
106,83,2,1,1,0
106,123,6,2,4,247.8
107,7,8,3,5,418.4
107,8,3,3,0,0
107,72,6,3,3,313.8
107,73,5,3,2,259
107,78,27,12,15,761.4
107,79,3,2,1,0
107,80,7,4,3,294.7
107,81,1,1,0,0
107,83,10,6,4,276
107,84,4,2,2,0
108,70,2,1,1,0
108,75,8,5,3,355.2
108,78,1,1,0,0
108,80,10,3,7,637
108,81,4,2,2,0
108,84,4,3,1,0
109,8,14,7,7,733.6
109,71,2,1,1,0
109,80,3,2,1,0
110,10,13,8,5,608.4
110,11,5,2,3,260
110,71,3,1,2,0
111,7,3,2,1,0
111,8,3,0,3,0
111,11,6,4,2,271.2
111,12,2,1,1,0
112,6,8,2,6,440
112,12,10,6,4,350
112,70,11,5,6,605
112,71,1,0,1,0
112,112,6,5,1,160.2
112,114,4,3,1,0
113,8,2,2,0,0
113,13,57,27,30,3197.7
113,14,40,18,22,1816
113,71,2,1,1,0
114,14,9,5,4,491.4
114,16,4,2,2,0
115,17,4,3,1,0
115,27,18,9,9,489.6
117,16,1,1,0,0
117,19,2,2,0,0
118,4,1,1,0,0
118,5,4,2,2,0
118,77,3,2,1,0
119,78,3,2,1,0
120,78,9,5,4,519.3
121,24,94,44,50,3816.4
121,78,12,6,6,669.6
122,24,15,6,9,547.5
122,25,16,8,8,625.6
123,24,2,2,0,0
124,22,6,3,3,229.8
124,24,9,5,4,289.8
124,25,4,2,2,0
124,27,2,1,1,0
124,28,5,3,2,298
124,31,11,4,7,416.9
124,32,6,2,4,162
125,1,10,6,4,439
125,2,13,7,6,704.6
125,31,11,4,7,467.5
125,32,6,4,2,217.2
126,1,8,5,3,480.8
126,2,2,1,1,0
126,26,2,1,1,0
126,27,5,3,2,70
127,27,2,1,1,0
127,28,14,5,9,687.4